
czerwca | GTYPE:gaz_month | G_LEMMA:czerwiec | G_NUM_BASE:06 | SURFACE:czerwca | G_LANG:PL
czerwiec | GTYPE:gaz_month | G_LEMMA:czerwiec | G_NUM_BASE:06 | SURFACE:czerwiec | G_LANG:PL
grudnia | GTYPE:gaz_month | G_LEMMA:grudzień | G_NUM_BASE:12 | SURFACE:grudnia | G_LANG:PL
grudzień | GTYPE:gaz_month | G_LEMMA:grudzień | G_NUM_BASE:12 | SURFACE:grudzień | G_LANG:PL
kwiecień | GTYPE:gaz_month | G_LEMMA:kwiecień | G_NUM_BASE:04 | SURFACE:kwiecień | G_LANG:PL
kwietnia | GTYPE:gaz_month | G_LEMMA:kwiecień | G_NUM_BASE:04 | SURFACE:kwietnia | G_LANG:PL
lipca | GTYPE:gaz_month | G_LEMMA:lipiec | G_NUM_BASE:07 | SURFACE:lipca | G_LANG:PL
lipiec | GTYPE:gaz_month | G_LEMMA:lipiec | G_NUM_BASE:07 | SURFACE:lipiec | G_LANG:PL
listopada | GTYPE:gaz_month | G_LEMMA:listopad | G_NUM_BASE:11 | SURFACE:listopada | G_LANG:PL
listopad | GTYPE:gaz_month | G_LEMMA:listopad | G_NUM_BASE:11 | SURFACE:listopad | G_LANG:PL
lutego | GTYPE:gaz_month | G_LEMMA:luty | G_NUM_BASE:02 | SURFACE:lutego | G_LANG:PL
luty | GTYPE:gaz_month | G_LEMMA:luty | G_NUM_BASE:02 | SURFACE:luty | G_LANG:PL
maja | GTYPE:gaz_month | G_LEMMA:maj | G_NUM_BASE:05 | SURFACE:maja | G_LANG:PL
maj | GTYPE:gaz_month | G_LEMMA:maj | G_NUM_BASE:05 | SURFACE:maj | G_LANG:PL
marca | GTYPE:gaz_month | G_LEMMA:marzec | G_NUM_BASE:03 | SURFACE:marca | G_LANG:PL
marzec | GTYPE:gaz_month | G_LEMMA:marzec | G_NUM_BASE:03 | SURFACE:marzec | G_LANG:PL
października | GTYPE:gaz_month | G_LEMMA:październik | G_NUM_BASE:10 | SURFACE:października | G_LANG:PL
październik | GTYPE:gaz_month | G_LEMMA:październik | G_NUM_BASE:10 | SURFACE:października | G_LANG:PL
sierpień | GTYPE:gaz_month | G_LEMMA:sierpień | G_NUM_BASE:08 | SURFACE:sierpień | G_LANG:PL
sierpnia | GTYPE:gaz_month | G_LEMMA:sierpień | G_NUM_BASE:08 | SURFACE:sierpnia | G_LANG:PL
styczeń | GTYPE:gaz_month | G_LEMMA:styczeń | G_NUM_BASE:01 | SURFACE:styczeń | G_LANG:PL
stycznia | GTYPE:gaz_month | G_LEMMA:styczeń | G_NUM_BASE:01 | SURFACE:stycznia | G_LANG:PL
wrzesień | GTYPE:gaz_month | G_LEMMA:wrzesień | G_NUM_BASE:09 | SURFACE:wrzesień | G_LANG:PL
września | GTYPE:gaz_month | G_LEMMA:wrzesień | G_NUM_BASE:09 | SURFACE:września | G_LANG:PL

January | GTYPE:gaz_month | G_LEMMA:January | G_NUM_BASE:01 | SURFACE:January | G_LANG:EN
February | GTYPE:gaz_month | G_LEMMA:February | G_NUM_BASE:02 | SURFACE:February | G_LANG:EN
March | GTYPE:gaz_month | G_LEMMA:March | G_NUM_BASE:03 | SURFACE:March | G_LANG:EN
April | GTYPE:gaz_month | G_LEMMA:April | G_NUM_BASE:04 | SURFACE:April | G_LANG:EN
May | GTYPE:gaz_month | G_LEMMA:May | G_NUM_BASE:05 | SURFACE:May | G_LANG:EN
June | GTYPE:gaz_month | G_LEMMA:June | G_NUM_BASE:06 | SURFACE:June | G_LANG:EN
July | GTYPE:gaz_month | G_LEMMA:July | G_NUM_BASE:07 | SURFACE:July | G_LANG:EN
August | GTYPE:gaz_month | G_LEMMA:August | G_NUM_BASE:08 | SURFACE:August | G_LANG:EN
September | GTYPE:gaz_month | G_LEMMA:September | G_NUM_BASE:09 | SURFACE:September | G_LANG:EN
October | GTYPE:gaz_month | G_LEMMA:October | G_NUM_BASE:10 | SURFACE:October | G_LANG:EN
November | GTYPE:gaz_month | G_LEMMA:November | G_NUM_BASE:11 | SURFACE:November | G_LANG:EN
December | GTYPE:gaz_month | G_LEMMA:December | G_NUM_BASE:12 | SURFACE:December | G_LANG:EN



złote | GTYPE:gaz_currency | G_LEMMA:pln | SURFACE:złote | G_LANG:PL
złotych | GTYPE:gaz_currency | G_LEMMA:pln | SURFACE:złotych | G_LANG:PL
zł. | GTYPE:gaz_currency | G_LEMMA:pln | SURFACE:zł. | G_LANG:PL
zł | GTYPE:gaz_currency | G_LEMMA:pln | SURFACE:zł | G_LANG:PL
dolary | GTYPE:gaz_currency | G_LEMMA:usd | SURFACE:dolary | G_LANG:PL
dolarów | GTYPE:gaz_currency | G_LEMMA:usd | SURFACE:dolarów | G_LANG:PL
dol. | GTYPE:gaz_currency | G_LEMMA:usd | SURFACE:dol.
dolary US | GTYPE:gaz_currency | G_LEMMA:usd | SURFACE:dolary US | G_LANG:PL
dolarów US | GTYPE:gaz_currency | G_LEMMA:usd | SURFACE:dolarów US | G_LANG:PL
dol. US | GTYPE:gaz_currency | G_LEMMA:usd | SURFACE:dol. US
dolary amerykańskie | GTYPE:gaz_currency | G_LEMMA:usd | SURFACE:dolary amerykańskie | G_LANG:PL
dolarów amerykańskich | GTYPE:gaz_currency | G_LEMMA:usd | SURFACE:dolarów amerykańskich | G_LANG:PL
dol. amerykańskich | GTYPE:gaz_currency | G_LEMMA:usd | SURFACE:dol. amerykańskich | G_LANG:PL
dolary australijskie | GTYPE:gaz_currency | G_LEMMA:aud | SURFACE:dolary australijskie | G_LANG:PL
dolarów australijskich | GTYPE:gaz_currency | G_LEMMA:aud | SURFACE:dolarów australijskich | G_LANG:PL
dol. australijskich | GTYPE:gaz_currency | G_LEMMA:aud | SURFACE:dol. australijskich | G_LANG:PL
dolary kanadyjskie | GTYPE:gaz_currency | G_LEMMA:cad | SURFACE:dolary kanadyjskie | G_LANG:PL
dolarów kanadyjskich | GTYPE:gaz_currency | G_LEMMA:cad | SURFACE:dolarów kanadyjskich | G_LANG:PL
dol. kanadyjskich | GTYPE:gaz_currency | G_LEMMA:cad | SURFACE:dol. kanadyjskich | G_LANG:PL
franki szwajcarskie | GTYPE:gaz_currency | G_LEMMA:chf | SURFACE:franki szwajcarskie | G_LANG:PL
franków szwajcarskich | GTYPE:gaz_currency | G_LEMMA:chf | SURFACE:franków szwajcarskich | G_LANG:PL
euro | GTYPE:gaz_currency | G_LEMMA:eur | SURFACE:euro
EURO | GTYPE:gaz_currency | G_LEMMA:eur | SURFACE:EURO
funty | GTYPE:gaz_currency | G_LEMMA:gbp | SURFACE:funty | G_LANG:PL
funtów | GTYPE:gaz_currency | G_LEMMA:gbp | SURFACE:funtów | G_LANG:PL
funty brytyjskie | GTYPE:gaz_currency | G_LEMMA:gbp | SURFACE:funty brytyjskie | G_LANG:PL
funtów brytyjskich | GTYPE:gaz_currency | G_LEMMA:gbp | SURFACE:funtów brytyjskich | G_LANG:PL
rubli | GTYPE:gaz_currency | G_LEMMA:rub | SURFACE:rubli | G_LANG:PL
ruble | GTYPE:gaz_currency | G_LEMMA:rub | SURFACE:ruble | G_LANG:PL
korony czeskie | GTYPE:gaz_currency | G_LEMMA:czk | SURFACE:korony czeskie | G_LANG:PL
koron czeskich | GTYPE:gaz_currency | G_LEMMA:czk | SURFACE:koron czeskich | G_LANG:PL
korony szwedzkie | GTYPE:gaz_currency | G_LEMMA:sek | SURFACE:korony szwedzkie | G_LANG:PL
koron szwedzkich | GTYPE:gaz_currency | G_LEMMA:sek | SURFACE:koron szwedzkich | G_LANG:PL
korony duńskie | GTYPE:gaz_currency | G_LEMMA:dkk | SURFACE:korony duńskie | G_LANG:PL
koron duńskich | GTYPE:gaz_currency | G_LEMMA:dkk | SURFACE:koron duńskich | G_LANG:PL
korony norweskie | GTYPE:gaz_currency | G_LEMMA:nok | SURFACE:korony norweskie | G_LANG:PL
koron norweskich | GTYPE:gaz_currency | G_LEMMA:nok | SURFACE:koron norweskich | G_LANG:PL
korony słowackie | GTYPE:gaz_currency | G_LEMMA:skk | SURFACE:korony słowackie | G_LANG:PL
koron słowackich | GTYPE:gaz_currency | G_LEMMA:skk | SURFACE:koron słowackich | G_LANG:PL
korony estońskie | GTYPE:gaz_currency | G_LEMMA:eek | SURFACE:korony estońskie | G_LANG:PL
koron estońskich | GTYPE:gaz_currency | G_LEMMA:eek | SURFACE:koron estońskich | G_LANG:PL
korony | GTYPE:gaz_currency | SURFACE:korony | G_LANG:PL
koron | GTYPE:gaz_currency | SURFACE:koron | G_LANG:PL
peso | GTYPE:gaz_currency | SURFACE:peso
riale | GTYPE:gaz_currency | G_LEMMA:sar | SURFACE:riale | G_LANG:PL
riali | GTYPE:gaz_currency | G_LEMMA:sar | SURFACE:riali | G_LANG:PL
reale | GTYPE:gaz_currency | G_LEMMA:brl | SURFACE:reale | G_LANG:PL
reali | GTYPE:gaz_currency | G_LEMMA:brl | SURFACE:reali | G_LANG:PL
lewa | GTYPE:gaz_currency | G_LEMMA:bgn | SURFACE:lewa | G_LANG:PL
juanów | GTYPE:gaz_currency | G_LEMMA:cny | SURFACE:juanów | G_LANG:PL
juany | GTYPE:gaz_currency | G_LEMMA:cny | SURFACE:juany | G_LANG:PL
kuny | GTYPE:gaz_currency | G_LEMMA:hrk | SURFACE:kuny | G_LANG:PL
kun | GTYPE:gaz_currency | G_LEMMA:hrk | SURFACE:kun | G_LANG:PL
nowe szekele | GTYPE:gaz_currency | G_LEMMA:ils | SURFACE:nowe szekele | G_LANG:PL
wowych szekeli | GTYPE:gaz_currency | G_LEMMA:ils | SURFACE:wowych szekeli | G_LANG:PL
jeny | GTYPE:gaz_currency | G_LEMMA:jpy | SURFACE:jeny | G_LANG:PL
jenów | GTYPE:gaz_currency | G_LEMMA:jpy | SURFACE:jenów | G_LANG:PL
lity | GTYPE:gaz_currency | G_LEMMA:ltl | SURFACE:lity | G_LANG:PL
litów | GTYPE:gaz_currency | G_LEMMA:ltl | SURFACE:litów | G_LANG:PL
lyty | GTYPE:gaz_currency | G_LEMMA:lvl | SURFACE:lyty | G_LANG:PL
lytów | GTYPE:gaz_currency | G_LEMMA:lvl | SURFACE:lytów | G_LANG:PL
dinary | GTYPE:gaz_currency | G_LEMMA:csd | SURFACE:dinary | G_LANG:PL
dinarów | GTYPE:gaz_currency | G_LEMMA:csd | SURFACE:dinarów | G_LANG:PL
hrywny | GTYPE:gaz_currency | G_LEMMA:uah | SURFACE:hrywny | G_LANG:PL
hrywien | GTYPE:gaz_currency | G_LEMMA:uah | SURFACE:hrywien | G_LANG:PL
hrywn | GTYPE:gaz_currency | G_LEMMA:uah | SURFACE:hrywn | G_LANG:PL
forinty | GTYPE:gaz_currency | G_LEMMA:huf | SURFACE:forinty | G_LANG:PL
forintów | GTYPE:gaz_currency | G_LEMMA:huf | SURFACE:forintów | G_LANG:PL
HKD | GTYPE:gaz_currency | G_LEMMA:hkd | SURFACE:HKD
JPY | GTYPE:gaz_currency | G_LEMMA:jpy | SURFACE:JPY
EUR | GTYPE:gaz_currency | G_LEMMA:eur | SURFACE:EUR
USD | GTYPE:gaz_currency | G_LEMMA:usd | SURFACE:USD
PLN | GTYPE:gaz_currency | G_LEMMA:pln | SURFACE:PLN
SEK | GTYPE:gaz_currency | G_LEMMA:sek | SURFACE:SEK
CHF | GTYPE:gaz_currency | G_LEMMA:chf | SURFACE:CHF
GBP | GTYPE:gaz_currency | G_LEMMA:gbp | SURFACE:GBP
RUB | GTYPE:gaz_currency | G_LEMMA:rub | SURFACE:RUB
CZK | GTYPE:gaz_currency | G_LEMMA:czk | SURFACE:CZK
SAR | GTYPE:gaz_currency | G_LEMMA:sar | SURFACE:SAR
ARS | GTYPE:gaz_currency | G_LEMMA:ars | SURFACE:ARS
AUD | GTYPE:gaz_currency | G_LEMMA:aud | SURFACE:AUD
BRL | GTYPE:gaz_currency | G_LEMMA:brl | SURFACE:BRL
BGN | GTYPE:gaz_currency | G_LEMMA:bgn | SURFACE:BGN
CNY | GTYPE:gaz_currency | G_LEMMA:cny | SURFACE:CNY
HRK | GTYPE:gaz_currency | G_LEMMA:hrk | SURFACE:HRK
CYP | GTYPE:gaz_currency | G_LEMMA:cyp | SURFACE:CYP
DKK | GTYPE:gaz_currency | G_LEMMA:dkk | SURFACE:DKK
EEK | GTYPE:gaz_currency | G_LEMMA:eek | SURFACE:EEK
ILS | GTYPE:gaz_currency | G_LEMMA:ils | SURFACE:ILS
CAD | GTYPE:gaz_currency | G_LEMMA:cad | SURFACE:CAD
LTL | GTYPE:gaz_currency | G_LEMMA:ltl | SURFACE:LTL
LVL | GTYPE:gaz_currency | G_LEMMA:lvl | SURFACE:LVL
NOK | GTYPE:gaz_currency | G_LEMMA:nok | SURFACE:NOK
PEN | GTYPE:gaz_currency | G_LEMMA:pen | SURFACE:PEN
CSD | GTYPE:gaz_currency | G_LEMMA:csd | SURFACE:CSD
SKK | GTYPE:gaz_currency | G_LEMMA:skk | SURFACE:SKK
SIT | GTYPE:gaz_currency | G_LEMMA:sit | SURFACE:SIT
UAH | GTYPE:gaz_currency | G_LEMMA:uah | SURFACE:UAH
VEB | GTYPE:gaz_currency | G_LEMMA:veb | SURFACE:VEB
HUF | GTYPE:gaz_currency | G_LEMMA:huf | SURFACE:HUF
AED | GTYPE:gaz_currency | G_LEMMA:aed | SURFACE:AED

miliard | GTYPE:gaz_numberword | G_VAL:1000000000 | SURFACE:miliard | G_LEMMA:miliard | G_LANG:PL
miliarda | GTYPE:gaz_numberword | G_VAL:1000000000 | SURFACE:miliarda | G_LEMMA:miliard | G_LANG:PL
miliardy | GTYPE:gaz_numberword | G_VAL:1000000000 | SURFACE:miliardy | G_LEMMA:miliard | G_LANG:PL
miliardom | GTYPE:gaz_numberword | G_VAL:1000000000 | SURFACE:miliardom | G_LEMMA:miliard | G_LANG:PL
miliardowi | GTYPE:gaz_numberword | G_VAL:1000000000 | SURFACE:miliardowi | G_LEMMA:miliard | G_LANG:PL
miliardem | GTYPE:gaz_numberword | G_VAL:1000000000 | SURFACE:miliardem | G_LEMMA:miliard | G_LANG:PL
miliardzie | GTYPE:gaz_numberword | G_VAL:1000000000 | SURFACE:miliardzie | G_LEMMA:miliard | G_LANG:PL
miliardów | GTYPE:gaz_numberword | G_VAL:1000000000 | SURFACE:miliardów | G_LEMMA:miliard | G_LANG:PL
miliardami | GTYPE:gaz_numberword | G_VAL:1000000000 | SURFACE:miliardami | G_LEMMA:miliard | G_LANG:PL
miliardach | GTYPE:gaz_numberword | G_VAL:1000000000 | SURFACE:miliardach | G_LEMMA:miliard | G_LANG:PL

milion | GTYPE:gaz_numberword | G_VAL:1000000 | SURFACE:milion | G_LEMMA:milion | G_LANG:PL
miliona | GTYPE:gaz_numberword | G_VAL:1000000 | SURFACE:miliona | G_LEMMA:milion | G_LANG:PL
milionowi | GTYPE:gaz_numberword | G_VAL:1000000 | SURFACE:milionowi | G_LEMMA:milion | G_LANG:PL
milionem | GTYPE:gaz_numberword | G_VAL:1000000 | SURFACE:milionem | G_LEMMA:milion | G_LANG:PL
milionie | GTYPE:gaz_numberword | G_VAL:1000000 | SURFACE:milionie | G_LEMMA:milion | G_LANG:PL
miliony | GTYPE:gaz_numberword | G_VAL:1000000 | SURFACE:miliony | G_LEMMA:milion | G_LANG:PL
milionom | GTYPE:gaz_numberword | G_VAL:1000000 | SURFACE:milionom | G_LEMMA:milion | G_LANG:PL
milionami | GTYPE:gaz_numberword | G_VAL:1000000 | SURFACE:milionami | G_LEMMA:milion | G_LANG:PL
milionach | GTYPE:gaz_numberword | G_VAL:1000000 | SURFACE:milionach | G_LEMMA:milion | G_LANG:PL
milionów | GTYPE:gaz_numberword | G_VAL:1000000 | SURFACE:milionów | G_LEMMA:milion | G_LANG:PL

mln | GTYPE:gaz_numberword | G_VAL:1000000 | SURFACE:mln | G_LEMMA:milion | G_LANG:PL
mln. | GTYPE:gaz_numberword | G_VAL:1000000 | SURFACE:mln. | G_LEMMA:milion | G_LANG:PL
mrd | GTYPE:gaz_numberword | G_VAL:1000000000 | SURFACE:mrd | G_LEMMA:miliard | G_LANG:PL
mrd. | GTYPE:gaz_numberword | G_VAL:1000000000 | SURFACE:mrd. | G_LEMMA:miliard | G_LANG:PL

tys. | GTYPE:gaz_numberword | G_VAL:1000 | SURFACE:tys. | G_LEMMA:tysiąc | G_LANG:PL
tysiąc | GTYPE:gaz_numberword | G_VAL:1000 | SURFACE:tysiąc | G_LEMMA:tysiąc | G_LANG:PL
tysiąca | GTYPE:gaz_numberword | G_VAL:1000 | SURFACE:tysiąca | G_LEMMA:tysiąc | G_LANG:PL
tysiącowi | GTYPE:gaz_numberword | G_VAL:1000 | SURFACE:tysiącowi | G_LEMMA:tysiąc | G_LANG:PL
tysiącem | GTYPE:gaz_numberword | G_VAL:1000 | SURFACE:tysiącem | G_LEMMA:tysiąc | G_LANG:PL
tysiącu | GTYPE:gaz_numberword | G_VAL:1000 | SURFACE:tysiącu | G_LEMMA:tysiąc | G_LANG:PL
tysiące | GTYPE:gaz_numberword | G_VAL:1000 | SURFACE:tysiące | G_LEMMA:tysiąc | G_LANG:PL
tysięcom | GTYPE:gaz_numberword | G_VAL:1000 | SURFACE:tysiącom | G_LEMMA:tysiąc | G_LANG:PL
tysiącami | GTYPE:gaz_numberword | G_VAL:1000 | SURFACE:tysiącami | G_LEMMA:tysiąc | G_LANG:PL
tysiącach | GTYPE:gaz_numberword | G_VAL:1000 | SURFACE:tysiącach | G_LEMMA:tysiąc | G_LANG:PL
tysięcy | GTYPE:gaz_numberword | G_VAL:1000 | SURFACE:tysięcy | G_LEMMA:tysiąc | G_LANG:PL

milimetr | GTYPE:gaz_measurement | G_M_TYPE:physical_extent | G_M_UNIT:milimeter | SURFACE:milimetr | G_LANG:PL
milimetra | GTYPE:gaz_measurement | G_M_TYPE:physical_extent | G_M_UNIT:milimeter | SURFACE:milimetra | G_LANG:PL
milimetrowi | GTYPE:gaz_measurement | G_M_TYPE:physical_extent | G_M_UNIT:milimeter | SURFACE:milimetrowi | G_LANG:PL
milimetrem | GTYPE:gaz_measurement | G_M_TYPE:physical_extent | G_M_UNIT:milimeter | SURFACE:milimetrem | G_LANG:PL
milimetrze | GTYPE:gaz_measurement | G_M_TYPE:physical_extent | G_M_UNIT:milimeter | SURFACE:milimetrze | G_LANG:PL
centymetr | GTYPE:gaz_measurement | G_M_TYPE:physical_extent | G_M_UNIT:centimeter | SURFACE:centymetr | G_LANG:PL
centymetra | GTYPE:gaz_measurement | G_M_TYPE:physical_extent | G_M_UNIT:centimeter | SURFACE:centymetra | G_LANG:PL
centymetrowi | GTYPE:gaz_measurement | G_M_TYPE:physical_extent | G_M_UNIT:centimeter | SURFACE:centymetrowi | G_LANG:PL
centymetrem | GTYPE:gaz_measurement | G_M_TYPE:physical_extent | G_M_UNIT:centimeter | SURFACE:centymetrem | G_LANG:PL
centymetrze | GTYPE:gaz_measurement | G_M_TYPE:physical_extent | G_M_UNIT:centimeter | SURFACE:centymetrze | G_LANG:PL
metr | GTYPE:gaz_measurement | G_M_TYPE:physical_extent | G_M_UNIT:meter | SURFACE:metr | G_LANG:PL
metra | GTYPE:gaz_measurement | G_M_TYPE:physical_extent | G_M_UNIT:meter | SURFACE:metra | G_LANG:PL
metrowi | GTYPE:gaz_measurement | G_M_TYPE:physical_extent | G_M_UNIT:meter | SURFACE:metrowi | G_LANG:PL
metrem | GTYPE:gaz_measurement | G_M_TYPE:physical_extent | G_M_UNIT:meter | SURFACE:metrem | G_LANG:PL
metrze | GTYPE:gaz_measurement | G_M_TYPE:physical_extent | G_M_UNIT:meter | SURFACE:metrze | G_LANG:PL
kilometr | GTYPE:gaz_measurement | G_M_TYPE:physical_extent | G_M_UNIT:kilometer | SURFACE:kilometr | G_LANG:PL
kilometra | GTYPE:gaz_measurement | G_M_TYPE:physical_extent | G_M_UNIT:kilometer | SURFACE:kilometra | G_LANG:PL
kilometrowi | GTYPE:gaz_measurement | G_M_TYPE:physical_extent | G_M_UNIT:kilometer | SURFACE:kilometrowi | G_LANG:PL
kilometrem | GTYPE:gaz_measurement | G_M_TYPE:physical_extent | G_M_UNIT:kilometer | SURFACE:kilometrem | G_LANG:PL
kilometrze | GTYPE:gaz_measurement | G_M_TYPE:physical_extent | G_M_UNIT:kilometer | SURFACE:kilometrze | G_LANG:PL
mm | GTYPE:gaz_measurement | G_M_TYPE:physical_extent | G_M_UNIT:milimeter | SURFACE:mm
cm | GTYPE:gaz_measurement | G_M_TYPE:physical_extent | G_M_UNIT:centimeter | SURFACE:cm
m | GTYPE:gaz_measurement | G_M_TYPE:physical_extent | G_M_UNIT:meter | SURFACE:m
km | GTYPE:gaz_measurement | G_M_TYPE:physical_extent | G_M_UNIT:kilometer | SURFACE:km
milimetry | GTYPE:gaz_measurement | G_M_TYPE:physical_extent | G_M_UNIT:milimeter | SURFACE:milimetry | G_LANG:PL
milimetrami | GTYPE:gaz_measurement | G_M_TYPE:physical_extent | G_M_UNIT:milimeter | SURFACE:milimetrami | G_LANG:PL
milimetrom | GTYPE:gaz_measurement | G_M_TYPE:physical_extent | G_M_UNIT:milimeter | SURFACE:milimetrom | G_LANG:PL
milimetrach | GTYPE:gaz_measurement | G_M_TYPE:physical_extent | G_M_UNIT:milimeter | SURFACE:milimetrach | G_LANG:PL
milimetrów | GTYPE:gaz_measurement | G_M_TYPE:physical_extent | G_M_UNIT:milimeter | SURFACE:milimetrów | G_LANG:PL
centymetry | GTYPE:gaz_measurement | G_M_TYPE:physical_extent | G_M_UNIT:centimeter | SURFACE:centymetry | G_LANG:PL
centymetrami | GTYPE:gaz_measurement | G_M_TYPE:physical_extent | G_M_UNIT:centimeter | SURFACE:centymetrami | G_LANG:PL
centymetrom | GTYPE:gaz_measurement | G_M_TYPE:physical_extent | G_M_UNIT:centimeter | SURFACE:centymetrom | G_LANG:PL
centymetrach | GTYPE:gaz_measurement | G_M_TYPE:physical_extent | G_M_UNIT:centimeter | SURFACE:centymetrach | G_LANG:PL
centymetrów | GTYPE:gaz_measurement | G_M_TYPE:physical_extent | G_M_UNIT:centimeter | SURFACE:centymetrów | G_LANG:PL
metry | GTYPE:gaz_measurement | G_M_TYPE:physical_extent | G_M_UNIT:meter | SURFACE:metry | G_LANG:PL
metrami | GTYPE:gaz_measurement | G_M_TYPE:physical_extent | G_M_UNIT:meter | SURFACE:metrami | G_LANG:PL
metrom | GTYPE:gaz_measurement | G_M_TYPE:physical_extent | G_M_UNIT:meter | SURFACE:metrom | G_LANG:PL
metrach | GTYPE:gaz_measurement | G_M_TYPE:physical_extent | G_M_UNIT:meter | SURFACE:metrach | G_LANG:PL
metrów | GTYPE:gaz_measurement | G_M_TYPE:physical_extent | G_M_UNIT:meter | SURFACE:metrów | G_LANG:PL
kilometry | GTYPE:gaz_measurement | G_M_TYPE:physical_extent | G_M_UNIT:kilometer | SURFACE:kilometry |G_LANG:PL 
kilometrami | GTYPE:gaz_measurement | G_M_TYPE:physical_extent | G_M_UNIT:kilometer | SURFACE:kilometrami | G_LANG:PL
kilometrom | GTYPE:gaz_measurement | G_M_TYPE:physical_extent | G_M_UNIT:kilometer | SURFACE:kilometrom | G_LANG:PL
kilometrach | GTYPE:gaz_measurement | G_M_TYPE:physical_extent | G_M_UNIT:kilometer | SURFACE:kilometrach | G_LANG:PL
kilometrów | GTYPE:gaz_measurement | G_M_TYPE:physical_extent | G_M_UNIT:kilometer | SURFACE:kilometrów | G_LANG:PL
milimetr kwadratowy | GTYPE:gaz_measurement | G_M_TYPE:space | G_M_UNIT:milimeter2 | SURFACE:milimetr kwadratowy | G_LANG:PL
milimetra kwadratowego | GTYPE:gaz_measurement | G_M_TYPE:space | G_M_UNIT:milimeter2 | SURFACE:milimetra kwadratowego | G_LANG:PL
milimetrowi kwadratowemu | GTYPE:gaz_measurement | G_M_TYPE:space | G_M_UNIT:milimeter2 | SURFACE:milimetrowi kwadratowemu | G_LANG:PL
milimetrem kwadratowym | GTYPE:gaz_measurement | G_M_TYPE:space | G_M_UNIT:milimeter2 | SURFACE:milimetrem kwadratowym | G_LANG:PL
milimetrze kwadratowym | GTYPE:gaz_measurement | G_M_TYPE:space | G_M_UNIT:milimeter2 | SURFACE:milimetrze kwadratowym | G_LANG:PL
centymetr kwadratowy | GTYPE:gaz_measurement | G_M_TYPE:space | G_M_UNIT:centimeter2 | SURFACE:centymetr kwadratowy | G_LANG:PL
centymetra kwadratowego | GTYPE:gaz_measurement | G_M_TYPE:space | G_M_UNIT:centimeter2 | SURFACE:centymetra kwadratowego | G_LANG:PL
centymetrowi kwadratowemu | GTYPE:gaz_measurement | G_M_TYPE:space | G_M_UNIT:centimeter2 | SURFACE:centymetrowi kwadratowemu | G_LANG:PL
centymetrem kwadratowym | GTYPE:gaz_measurement | G_M_TYPE:space | G_M_UNIT:centimeter2 | SURFACE:centymetrem kwadratowym | G_LANG:PL
centymetrze kwadratowym | GTYPE:gaz_measurement | G_M_TYPE:space | G_M_UNIT:centimeter2 | SURFACE:centymetrze kwadratowym | G_LANG:PL
metr kwadratowy | GTYPE:gaz_measurement | G_M_TYPE:space | G_M_UNIT:meter2 | SURFACE:metr kwadratowy | G_LANG:PL
metra kwadratowego | GTYPE:gaz_measurement | G_M_TYPE:space | G_M_UNIT:meter2 | SURFACE:metra kwadratowego | G_LANG:PLG_LANG:PL
metrowi kwadratowemu | GTYPE:gaz_measurement | G_M_TYPE:space | G_M_UNIT:meter2 | SURFACE:metrowi kwadratowemu | G_LANG:PL
metrem kwadratowym | GTYPE:gaz_measurement | G_M_TYPE:space | G_M_UNIT:meter2 | SURFACE:metrem kwadratowym | G_LANG:PL
metrze kwadratowym | GTYPE:gaz_measurement | G_M_TYPE:space | G_M_UNIT:meter2 | SURFACE:metrze kwadratowym | G_LANG:PL
kilometr kwadratowy | GTYPE:gaz_measurement | G_M_TYPE:space | G_M_UNIT:kilometer2 | SURFACE:kilometr kwadratowy | G_LANG:PL
kilometra kwadratowego | GTYPE:gaz_measurement | G_M_TYPE:space | G_M_UNIT:kilometer2 | SURFACE:kilometra kwadratowego | G_LANG:PL
kilometrowi kwadratowemu | GTYPE:gaz_measurement | G_M_TYPE:space | G_M_UNIT:kilometer2 | SURFACE:kilometrowi kwadratowemu | G_LANG:PL
kilometrem kwadratowym | GTYPE:gaz_measurement | G_M_TYPE:space | G_M_UNIT:kilometer2 | SURFACE:kilometrem kwadratowym | G_LANG:PL
kilometrze kwadratowym | GTYPE:gaz_measurement | G_M_TYPE:space | G_M_UNIT:kilometer2 | SURFACE:kilometrze kwadratowym | G_LANG:PL
milimetry kwadratowe | GTYPE:gaz_measurement | G_M_TYPE:space | G_M_UNIT:milimeter2 | SURFACE:milimetry kwadratowe | G_LANG:PL
milimetrami kwadratowymi | GTYPE:gaz_measurement | G_M_TYPE:space | G_M_UNIT:milimeter2 | SURFACE:milimetrami kwadratowymi | G_LANG:PL
milimetrom kwadratowym | GTYPE:gaz_measurement | G_M_TYPE:space | G_M_UNIT:milimeter2 | SURFACE:milimetrom kwadratowym | G_LANG:PL
milimetrach kwadratowych | GTYPE:gaz_measurement | G_M_TYPE:space | G_M_UNIT:milimeter2 | SURFACE:milimetrach kwadratowych | G_LANG:PL
milimetrów kwadratowych | GTYPE:gaz_measurement | G_M_TYPE:space | G_M_UNIT:milimeter2 | SURFACE:milimetrów kwadratowych | G_LANG:PL
centymetry kwadratowe | GTYPE:gaz_measurement | G_M_TYPE:space | G_M_UNIT:centimeter2 | SURFACE:centymetry kwadratowe | G_LANG:PL
centymetrami kwadratowymi | GTYPE:gaz_measurement | G_M_TYPE:space | G_M_UNIT:centimeter2 | SURFACE:centymetrami kwadratowymi | G_LANG:PL
centymetrom kwadratowym | GTYPE:gaz_measurement | G_M_TYPE:space | G_M_UNIT:centimeter2 | SURFACE:centymetrom kwadratowym | G_LANG:PL
centymetrach kwadratowych | GTYPE:gaz_measurement | G_M_TYPE:space | G_M_UNIT:centimeter2 | SURFACE:centymetrach kwadratowych | G_LANG:PL
centymetrów kwadratowych | GTYPE:gaz_measurement | G_M_TYPE:space | G_M_UNIT:centimeter2 | SURFACE:centymetrów kwadratowych | G_LANG:PL
metry kwadratowe | GTYPE:gaz_measurement | G_M_TYPE:space | G_M_UNIT:meter2 | SURFACE:metry kwadratowe | G_LANG:PL
metrami kwadratowymi | GTYPE:gaz_measurement | G_M_TYPE:space | G_M_UNIT:meter2 | SURFACE:metrami kwadratowymi | G_LANG:PL
metrom kwadratowym | GTYPE:gaz_measurement | G_M_TYPE:space | G_M_UNIT:meter2 | SURFACE:metrom kwadratowym | G_LANG:PL
metrach kwadratowych | GTYPE:gaz_measurement | G_M_TYPE:space | G_M_UNIT:meter2 | SURFACE:metrach kwadratowych | G_LANG:PL
metrów kwadratowych | GTYPE:gaz_measurement | G_M_TYPE:space | G_M_UNIT:meter2 | SURFACE:metrów kwadratowych | G_LANG:PL
kilometry kwadratowe | GTYPE:gaz_measurement | G_M_TYPE:space | G_M_UNIT:kilometer2 | SURFACE:kilometry kwadratowe | G_LANG:PL
kilometrami kwadratowymi | GTYPE:gaz_measurement | G_M_TYPE:space | G_M_UNIT:kilometer2 | SURFACE:kilometrami kwadratowymi | G_LANG:PL
kilometrom kwadratowym | GTYPE:gaz_measurement | G_M_TYPE:space | G_M_UNIT:kilometer2 | SURFACE:kilometrom kwadratowym | G_LANG:PL
kilometrach kwadratowych | GTYPE:gaz_measurement | G_M_TYPE:space | G_M_UNIT:kilometer2 | SURFACE:kilometrach kwadratowych | G_LANG:PL
kilometrów kwadratowych | GTYPE:gaz_measurement | G_M_TYPE:space | G_M_UNIT:kilometer2 | SURFACE:kilometrów kwadratowych | G_LANG:PL
milimetr kwadr. | GTYPE:gaz_measurement | G_M_TYPE:space | G_M_UNIT:milimeter2 | SURFACE:milimetr kwadr. | G_LANG:PL
milimetra kwadr. | GTYPE:gaz_measurement | G_M_TYPE:space | G_M_UNIT:milimeter2 | SURFACE:milimetra kwadr. | G_LANG:PL
milimetrowi kwadr. | GTYPE:gaz_measurement | G_M_TYPE:space | G_M_UNIT:milimeter2 | SURFACE:milimetrowi kwadr. | G_LANG:PL
milimetrem kwadr. | GTYPE:gaz_measurement | G_M_TYPE:space | G_M_UNIT:milimeter2 | SURFACE:milimetrem kwadr. | G_LANG:PL
milimetrze kwadr. | GTYPE:gaz_measurement | G_M_TYPE:space | G_M_UNIT:milimeter2 | SURFACE:milimetrze kwadr. | G_LANG:PL
centymetr kwadr. | GTYPE:gaz_measurement | G_M_TYPE:space | G_M_UNIT:centimeter2 | SURFACE:centymetr kwadr. | G_LANG:PL
centymetra kwadr. | GTYPE:gaz_measurement | G_M_TYPE:space | G_M_UNIT:centimeter2 | SURFACE:centymetra kwadr. | G_LANG:PL
centymetrowi kwadr. | GTYPE:gaz_measurement | G_M_TYPE:space | G_M_UNIT:centimeter2 | SURFACE:centymetrowi kwadr. | G_LANG:PL
centymetrem kwadr. | GTYPE:gaz_measurement | G_M_TYPE:space | G_M_UNIT:centimeter2 | SURFACE:centymetrem kwadr. | G_LANG:PL
centymetrze kwadr. | GTYPE:gaz_measurement | G_M_TYPE:space | G_M_UNIT:centimeter2 | SURFACE:centymetrze kwadr. | G_LANG:PL
metr kwadr. | GTYPE:gaz_measurement | G_M_TYPE:space | G_M_UNIT:meter2 | SURFACE:metr kwadr. | G_LANG:PL
metra kwadr. | GTYPE:gaz_measurement | G_M_TYPE:space | G_M_UNIT:meter2 | SURFACE:metra kwadr. | G_LANG:PL
metrowi kwadr. | GTYPE:gaz_measurement | G_M_TYPE:space | G_M_UNIT:meter2 | SURFACE:metrowi kwadr. | G_LANG:PL
metrem kwadr. | GTYPE:gaz_measurement | G_M_TYPE:space | G_M_UNIT:meter2 | SURFACE:metrem kwadr. | G_LANG:PL
metrze kwadr. | GTYPE:gaz_measurement | G_M_TYPE:space | G_M_UNIT:meter2 | SURFACE:metrze kwadr. | G_LANG:PL
kilometr kwadr. | GTYPE:gaz_measurement | G_M_TYPE:space | G_M_UNIT:kilometer2 | SURFACE:kilometr kwadr. | G_LANG:PL
kilometra kwadr. | GTYPE:gaz_measurement | G_M_TYPE:space | G_M_UNIT:kilometer2 | SURFACE:kilometra kwadr. | G_LANG:PL
kilometrowi kwadr. | GTYPE:gaz_measurement | G_M_TYPE:space | G_M_UNIT:kilometer2 | SURFACE:kilometrowi kwadr. | G_LANG:PL
kilometrem kwadr. | GTYPE:gaz_measurement | G_M_TYPE:space | G_M_UNIT:kilometer2 | SURFACE:kilometrem kwadr. | G_LANG:PL
kilometrze kwadr. | GTYPE:gaz_measurement | G_M_TYPE:space | G_M_UNIT:kilometer2 | SURFACE:kilometrze kwadr. | G_LANG:PL
milimetry kwadr. | GTYPE:gaz_measurement | G_M_TYPE:space | G_M_UNIT:milimeter2 | SURFACE:milimetry kwadr. | G_LANG:PL
milimetrami kwadr. | GTYPE:gaz_measurement | G_M_TYPE:space | G_M_UNIT:milimeter2 | SURFACE:milimetrami kwadr. | G_LANG:PL
milimetrom kwadr. | GTYPE:gaz_measurement | G_M_TYPE:space | G_M_UNIT:milimeter2 | SURFACE:milimetrom kwadr. | G_LANG:PL
milimetrach kwadr. | GTYPE:gaz_measurement | G_M_TYPE:space | G_M_UNIT:milimeter2 | SURFACE:milimetrach kwadr. | G_LANG:PL
milimetrów kwadr. | GTYPE:gaz_measurement | G_M_TYPE:space | G_M_UNIT:milimeter2 | SURFACE:milimetrów kwadr. | G_LANG:PL
centymetry kwadr. | GTYPE:gaz_measurement | G_M_TYPE:space | G_M_UNIT:centimeter2 | SURFACE:centymetry kwadr. | G_LANG:PL
centymetrami kwadr. | GTYPE:gaz_measurement | G_M_TYPE:space | G_M_UNIT:centimeter2 | SURFACE:centymetrami kwadr. | G_LANG:PL
centymetrom kwadr. | GTYPE:gaz_measurement | G_M_TYPE:space | G_M_UNIT:centimeter2 | SURFACE:centymetrom kwadr. | G_LANG:PL
centymetrach kwadr. | GTYPE:gaz_measurement | G_M_TYPE:space | G_M_UNIT:centimeter2 | SURFACE:centymetrach kwadr. | G_LANG:PL
centymetrów kwadr. | GTYPE:gaz_measurement | G_M_TYPE:space | G_M_UNIT:centimeter2 | SURFACE:centymetrów kwadr. | G_LANG:PL
metry kwadr. | GTYPE:gaz_measurement | G_M_TYPE:space | G_M_UNIT:meter2 | SURFACE:metry kwadr. | G_LANG:PL
metrami kwadr. | GTYPE:gaz_measurement | G_M_TYPE:space | G_M_UNIT:meter2 | SURFACE:metrami kwadr. | G_LANG:PL
metrom kwadr. | GTYPE:gaz_measurement | G_M_TYPE:space | G_M_UNIT:meter2 | SURFACE:metrom kwadr. | G_LANG:PL
metrach kwadr. | GTYPE:gaz_measurement | G_M_TYPE:space | G_M_UNIT:meter2 | SURFACE:metrach kwadr. | G_LANG:PL
metrów kwadr. | GTYPE:gaz_measurement | G_M_TYPE:space | G_M_UNIT:meter2 | SURFACE:metrów kwadr. | G_LANG:PL
kilometry kwadr. | GTYPE:gaz_measurement | G_M_TYPE:space | G_M_UNIT:kilometer2 | SURFACE:kilometry kwadr. |G_LANG:PL 
kilometrami kwadr. | GTYPE:gaz_measurement | G_M_TYPE:space | G_M_UNIT:kilometer2 | SURFACE:kilometrami kwadr. | G_LANG:PL
kilometrom kwadr. | GTYPE:gaz_measurement | G_M_TYPE:space | G_M_UNIT:kilometer2 | SURFACE:kilometrom kwadr. | G_LANG:PL
kilometrach kwadr. | GTYPE:gaz_measurement | G_M_TYPE:space | G_M_UNIT:kilometer2 | SURFACE:kilometrach kwadr. | G_LANG:PL
kilometrów kwadr. | GTYPE:gaz_measurement | G_M_TYPE:space | G_M_UNIT:kilometer2 | SURFACE:kilometrów kwadr. | G_LANG:PL
mm kwadr. | GTYPE:gaz_measurement | G_M_TYPE:space | G_M_UNIT:milimeter2 | SURFACE:mm kwadr. | G_LANG:PL
cm kwadr. | GTYPE:gaz_measurement | G_M_TYPE:space | G_M_UNIT:centimeter2 | SURFACE:cm kwadr. | G_LANG:PL
m kwadr. | GTYPE:gaz_measurement | G_M_TYPE:space | G_M_UNIT:meter2 | SURFACE:m kwadr. | G_LANG:PL
km kwadr. | GTYPE:gaz_measurement | G_M_TYPE:space | G_M_UNIT:kilometer2 | SURFACE:km kwadr. | G_LANG:PL
mm. kwadr. | GTYPE:gaz_measurement | G_M_TYPE:space | G_M_UNIT:milimeter2 | SURFACE:mm. kwadr. | G_LANG:PL
cm. kwadr. | GTYPE:gaz_measurement | G_M_TYPE:space | G_M_UNIT:centimeter2 | SURFACE:cm. kwadr. | G_LANG:PL
m. kwadr. | GTYPE:gaz_measurement | G_M_TYPE:space | G_M_UNIT:meter2 | SURFACE:m. kwadr. | G_LANG:PL
km. kwadr. | GTYPE:gaz_measurement | G_M_TYPE:space | G_M_UNIT:kilometer2 | SURFACE:km. kwadr. | G_LANG:PL
milimetr kwad. | GTYPE:gaz_measurement | G_M_TYPE:space | G_M_UNIT:milimeter2 | SURFACE:milimetr kwad. | G_LANG:PL
milimetra kwad. | GTYPE:gaz_measurement | G_M_TYPE:space | G_M_UNIT:milimeter2 | SURFACE:milimetra kwad. | G_LANG:PL
milimetrowi kwad. | GTYPE:gaz_measurement | G_M_TYPE:space | G_M_UNIT:milimeter2 | SURFACE:milimetrowi kwad. | G_LANG:PL
milimetrem kwad. | GTYPE:gaz_measurement | G_M_TYPE:space | G_M_UNIT:milimeter2 | SURFACE:milimetrem kwad. | G_LANG:PL
milimetrze kwad. | GTYPE:gaz_measurement | G_M_TYPE:space | G_M_UNIT:milimeter2 | SURFACE:milimetrze kwad. | G_LANG:PL
centymetr kwad. | GTYPE:gaz_measurement | G_M_TYPE:space | G_M_UNIT:centimeter2 | SURFACE:centymetr kwad. | G_LANG:PL
centymetra kwad. | GTYPE:gaz_measurement | G_M_TYPE:space | G_M_UNIT:centimeter2 | SURFACE:centymetra kwad. | G_LANG:PL
centymetrowi kwad. | GTYPE:gaz_measurement | G_M_TYPE:space | G_M_UNIT:centimeter2 | SURFACE:centymetrowi kwad. | G_LANG:PL
centymetrem kwad. | GTYPE:gaz_measurement | G_M_TYPE:space | G_M_UNIT:centimeter2 | SURFACE:centymetrem kwad. | G_LANG:PL
centymetrze kwad. | GTYPE:gaz_measurement | G_M_TYPE:space | G_M_UNIT:centimeter2 | SURFACE:centymetrze kwad. | G_LANG:PL
metr kwad. | GTYPE:gaz_measurement | G_M_TYPE:space | G_M_UNIT:meter2 | SURFACE:metr kwad. | G_LANG:PL
metra kwad. | GTYPE:gaz_measurement | G_M_TYPE:space | G_M_UNIT:meter2 | SURFACE:metra kwad. | G_LANG:PL
metrowi kwad. | GTYPE:gaz_measurement | G_M_TYPE:space | G_M_UNIT:meter2 | SURFACE:metrowi kwad. | G_LANG:PL
metrem kwad. | GTYPE:gaz_measurement | G_M_TYPE:space | G_M_UNIT:meter2 | SURFACE:metrem kwad. | G_LANG:PL
metrze kwad. | GTYPE:gaz_measurement | G_M_TYPE:space | G_M_UNIT:meter2 | SURFACE:metrze kwad. | G_LANG:PL
kilometr kwad. | GTYPE:gaz_measurement | G_M_TYPE:space | G_M_UNIT:kilometer2 | SURFACE:kilometr kwad. | G_LANG:PL
kilometra kwad. | GTYPE:gaz_measurement | G_M_TYPE:space | G_M_UNIT:kilometer2 | SURFACE:kilometra kwad. | G_LANG:PL
kilometrowi kwad. | GTYPE:gaz_measurement | G_M_TYPE:space | G_M_UNIT:kilometer2 | SURFACE:kilometrowi kwad. | G_LANG:PL
kilometrem kwad. | GTYPE:gaz_measurement | G_M_TYPE:space | G_M_UNIT:kilometer2 | SURFACE:kilometrem kwad. | G_LANG:PL
kilometrze kwad. | GTYPE:gaz_measurement | G_M_TYPE:space | G_M_UNIT:kilometer2 | SURFACE:kilometrze kwad. | G_LANG:PL
milimetry kwad. | GTYPE:gaz_measurement | G_M_TYPE:space | G_M_UNIT:milimeter2 | SURFACE:milimetry kwad. | G_LANG:PL
milimetrami kwad. | GTYPE:gaz_measurement | G_M_TYPE:space | G_M_UNIT:milimeter2 | SURFACE:milimetrami kwad. | G_LANG:PL
milimetrom kwad. | GTYPE:gaz_measurement | G_M_TYPE:space | G_M_UNIT:milimeter2 | SURFACE:milimetrom kwad. | G_LANG:PL
milimetrach kwad. | GTYPE:gaz_measurement | G_M_TYPE:space | G_M_UNIT:milimeter2 | SURFACE:milimetrach kwad. | G_LANG:PL
milimetrów kwad. | GTYPE:gaz_measurement | G_M_TYPE:space | G_M_UNIT:milimeter2 | SURFACE:milimetrów kwad. | G_LANG:PL
centymetry kwad. | GTYPE:gaz_measurement | G_M_TYPE:space | G_M_UNIT:centimeter2 | SURFACE:centymetry kwad. | G_LANG:PL
centymetrami kwad. | GTYPE:gaz_measurement | G_M_TYPE:space | G_M_UNIT:centimeter2 | SURFACE:centymetrami kwad. | G_LANG:PL
centymetrom kwad. | GTYPE:gaz_measurement | G_M_TYPE:space | G_M_UNIT:centimeter2 | SURFACE:centymetrom kwad. | G_LANG:PL
centymetrach kwad. | GTYPE:gaz_measurement | G_M_TYPE:space | G_M_UNIT:centimeter2 | SURFACE:centymetrach kwad. | G_LANG:PL
centymetrów kwad. | GTYPE:gaz_measurement | G_M_TYPE:space | G_M_UNIT:centimeter2 | SURFACE:centymetrów kwad. | G_LANG:PL
metry kwad. | GTYPE:gaz_measurement | G_M_TYPE:space | G_M_UNIT:meter2 | SURFACE:metry kwad. | G_LANG:PL
metrami kwad. | GTYPE:gaz_measurement | G_M_TYPE:space | G_M_UNIT:meter2 | SURFACE:metrami kwad. | G_LANG:PL
metrom kwad. | GTYPE:gaz_measurement | G_M_TYPE:space | G_M_UNIT:meter2 | SURFACE:metrom kwad. | G_LANG:PL
metrach kwad. | GTYPE:gaz_measurement | G_M_TYPE:space | G_M_UNIT:meter2 | SURFACE:metrach kwad. | G_LANG:PL
metrów kwad. | GTYPE:gaz_measurement | G_M_TYPE:space | G_M_UNIT:meter2 | SURFACE:metrów kwad. | G_LANG:PL
kilometry kwad. | GTYPE:gaz_measurement | G_M_TYPE:space | G_M_UNIT:kilometer2 | SURFACE:kilometry kwad. | G_LANG:PL
kilometrami kwad. | GTYPE:gaz_measurement | G_M_TYPE:space | G_M_UNIT:kilometer2 | SURFACE:kilometrami kwad. | G_LANG:PL
kilometrom kwad. | GTYPE:gaz_measurement | G_M_TYPE:space | G_M_UNIT:kilometer2 | SURFACE:kilometrom kwad. | G_LANG:PL
kilometrach kwad. | GTYPE:gaz_measurement | G_M_TYPE:space | G_M_UNIT:kilometer2 | SURFACE:kilometrach kwad. | G_LANG:PL
kilometrów kwad. | GTYPE:gaz_measurement | G_M_TYPE:space | G_M_UNIT:kilometer2 | SURFACE:kilometrów kwad. | G_LANG:PL
mm kwad. | GTYPE:gaz_measurement | G_M_TYPE:space | G_M_UNIT:milimeter2 | SURFACE:mm kwad. | G_LANG:PL
cm kwad. | GTYPE:gaz_measurement | G_M_TYPE:space | G_M_UNIT:centimeter2 | SURFACE:cm kwad. | G_LANG:PL
m kwad. | GTYPE:gaz_measurement | G_M_TYPE:space | G_M_UNIT:meter2 | SURFACE:m kwad. | G_LANG:PL
km kwad. | GTYPE:gaz_measurement | G_M_TYPE:space | G_M_UNIT:kilometer2 | SURFACE:km kwad. | G_LANG:PL
mm. kwad. | GTYPE:gaz_measurement | G_M_TYPE:space | G_M_UNIT:milimeter2 | SURFACE:mm. kwad. | G_LANG:PL
cm. kwad. | GTYPE:gaz_measurement | G_M_TYPE:space | G_M_UNIT:centimeter2 | SURFACE:cm. kwad. | G_LANG:PL
m. kwad. | GTYPE:gaz_measurement | G_M_TYPE:space | G_M_UNIT:meter2 | SURFACE:m. kwad. | G_LANG:PL
km. kwad. | GTYPE:gaz_measurement | G_M_TYPE:space | G_M_UNIT:kilometer2 | SURFACE:km. kwad. | G_LANG:PL
milimetr kw. | GTYPE:gaz_measurement | G_M_TYPE:space | G_M_UNIT:milimeter2 | SURFACE:milimetr kw. | G_LANG:PL
milimetra kw. | GTYPE:gaz_measurement | G_M_TYPE:space | G_M_UNIT:milimeter2 | SURFACE:milimetra kw. | G_LANG:PL
milimetrowi kw. | GTYPE:gaz_measurement | G_M_TYPE:space | G_M_UNIT:milimeter2 | SURFACE:milimetrowi kw. | G_LANG:PL
milimetrem kw. | GTYPE:gaz_measurement | G_M_TYPE:space | G_M_UNIT:milimeter2 | SURFACE:milimetrem kw. | G_LANG:PL
milimetrze kw. | GTYPE:gaz_measurement | G_M_TYPE:space | G_M_UNIT:milimeter2 | SURFACE:milimetrze kw. | G_LANG:PL
centymetr kw. | GTYPE:gaz_measurement | G_M_TYPE:space | G_M_UNIT:centimeter2 | SURFACE:centymetr kw. | G_LANG:PL
centymetra kw. | GTYPE:gaz_measurement | G_M_TYPE:space | G_M_UNIT:centimeter2 | SURFACE:centymetra kw. | G_LANG:PL
centymetrowi kw. | GTYPE:gaz_measurement | G_M_TYPE:space | G_M_UNIT:centimeter2 | SURFACE:centymetrowi kw. | G_LANG:PL
centymetrem kw. | GTYPE:gaz_measurement | G_M_TYPE:space | G_M_UNIT:centimeter2 | SURFACE:centymetrem kw. | G_LANG:PL
centymetrze kw. | GTYPE:gaz_measurement | G_M_TYPE:space | G_M_UNIT:centimeter2 | SURFACE:centymetrze kw. | G_LANG:PL
metr kw. | GTYPE:gaz_measurement | G_M_TYPE:space | G_M_UNIT:meter2 | SURFACE:metr kw. | G_LANG:PL
metra kw. | GTYPE:gaz_measurement | G_M_TYPE:space | G_M_UNIT:meter2 | SURFACE:metra kw. | G_LANG:PL
metrowi kw. | GTYPE:gaz_measurement | G_M_TYPE:space | G_M_UNIT:meter2 | SURFACE:metrowi kw. | G_LANG:PL
metrem kw. | GTYPE:gaz_measurement | G_M_TYPE:space | G_M_UNIT:meter2 | SURFACE:metrem kw. | G_LANG:PL
metrze kw. | GTYPE:gaz_measurement | G_M_TYPE:space | G_M_UNIT:meter2 | SURFACE:metrze kw. | G_LANG:PL
kilometr kw. | GTYPE:gaz_measurement | G_M_TYPE:space | G_M_UNIT:kilometer2 | SURFACE:kilometr kw. | G_LANG:PL
kilometra kw. | GTYPE:gaz_measurement | G_M_TYPE:space | G_M_UNIT:kilometer2 | SURFACE:kilometra kw. | G_LANG:PL
kilometrowi kw. | GTYPE:gaz_measurement | G_M_TYPE:space | G_M_UNIT:kilometer2 | SURFACE:kilometrowi kw. | G_LANG:PL
kilometrem kw. | GTYPE:gaz_measurement | G_M_TYPE:space | G_M_UNIT:kilometer2 | SURFACE:kilometrem kw. | G_LANG:PL
kilometrze kw. | GTYPE:gaz_measurement | G_M_TYPE:space | G_M_UNIT:kilometer2 | SURFACE:kilometrze kw. | G_LANG:PL
milimetry kw. | GTYPE:gaz_measurement | G_M_TYPE:space | G_M_UNIT:milimeter2 | SURFACE:milimetry kw. | G_LANG:PL
milimetrami kw. | GTYPE:gaz_measurement | G_M_TYPE:space | G_M_UNIT:milimeter2 | SURFACE:milimetrami kw. | G_LANG:PL
milimetrom kw. | GTYPE:gaz_measurement | G_M_TYPE:space | G_M_UNIT:milimeter2 | SURFACE:milimetrom kw. | G_LANG:PL
milimetrach kw. | GTYPE:gaz_measurement | G_M_TYPE:space | G_M_UNIT:milimeter2 | SURFACE:milimetrach kw. | G_LANG:PL
milimetrów kw. | GTYPE:gaz_measurement | G_M_TYPE:space | G_M_UNIT:milimeter2 | SURFACE:milimetrów kw. | G_LANG:PL
centymetry kw. | GTYPE:gaz_measurement | G_M_TYPE:space | G_M_UNIT:centimeter2 | SURFACE:centymetry kw. | G_LANG:PL
centymetrami kw. | GTYPE:gaz_measurement | G_M_TYPE:space | G_M_UNIT:centimeter2 | SURFACE:centymetrami kw. | G_LANG:PL
centymetrom kw. | GTYPE:gaz_measurement | G_M_TYPE:space | G_M_UNIT:centimeter2 | SURFACE:centymetrom kw. | G_LANG:PL
centymetrach kw. | GTYPE:gaz_measurement | G_M_TYPE:space | G_M_UNIT:centimeter2 | SURFACE:centymetrach kw. | G_LANG:PL
centymetrów kw. | GTYPE:gaz_measurement | G_M_TYPE:space | G_M_UNIT:centimeter2 | SURFACE:centymetrów kw. | G_LANG:PL
metry kw. | GTYPE:gaz_measurement | G_M_TYPE:space | G_M_UNIT:meter2 | SURFACE:metry kw. | G_LANG:PL
metrami kw. | GTYPE:gaz_measurement | G_M_TYPE:space | G_M_UNIT:meter2 | SURFACE:metrami kw. | G_LANG:PL
metrom kw. | GTYPE:gaz_measurement | G_M_TYPE:space | G_M_UNIT:meter2 | SURFACE:metrom kw. | G_LANG:PL
metrach kw. | GTYPE:gaz_measurement | G_M_TYPE:space | G_M_UNIT:meter2 | SURFACE:metrach kw. | G_LANG:PL
metrów kw. | GTYPE:gaz_measurement | G_M_TYPE:space | G_M_UNIT:meter2 | SURFACE:metrów kw. | G_LANG:PL
kilometry kw. | GTYPE:gaz_measurement | G_M_TYPE:space | G_M_UNIT:kilometer2 | SURFACE:kilometry kw. |G_LANG:PL 
kilometrami kw. | GTYPE:gaz_measurement | G_M_TYPE:space | G_M_UNIT:kilometer2 | SURFACE:kilometrami kw. | G_LANG:PL
kilometrom kw. | GTYPE:gaz_measurement | G_M_TYPE:space | G_M_UNIT:kilometer2 | SURFACE:kilometrom kw. | G_LANG:PL
kilometrach kw. | GTYPE:gaz_measurement | G_M_TYPE:space | G_M_UNIT:kilometer2 | SURFACE:kilometrach kw. | G_LANG:PL
kilometrów kw. | GTYPE:gaz_measurement | G_M_TYPE:space | G_M_UNIT:kilometer2 | SURFACE:kilometrów kw. | G_LANG:PL
mm kw. | GTYPE:gaz_measurement | G_M_TYPE:space | G_M_UNIT:milimeter2 | SURFACE:mm kw. | G_LANG:PL
cm kw. | GTYPE:gaz_measurement | G_M_TYPE:space | G_M_UNIT:centimeter2 | SURFACE:cm kw. | G_LANG:PL
m kw. | GTYPE:gaz_measurement | G_M_TYPE:space | G_M_UNIT:meter2 | SURFACE:m kw. | G_LANG:PL
km kw. | GTYPE:gaz_measurement | G_M_TYPE:space | G_M_UNIT:kilometer2 | SURFACE:km kw. | G_LANG:PL
mm. kw. | GTYPE:gaz_measurement | G_M_TYPE:space | G_M_UNIT:milimeter2 | SURFACE:mm. kw. | G_LANG:PL
cm. kw. | GTYPE:gaz_measurement | G_M_TYPE:space | G_M_UNIT:centimeter2 | SURFACE:cm. kw. | G_LANG:PL
m. kw. | GTYPE:gaz_measurement | G_M_TYPE:space | G_M_UNIT:meter2 | SURFACE:m. kw. | G_LANG:PL
km. kw. | GTYPE:gaz_measurement | G_M_TYPE:space | G_M_UNIT:kilometer2 | SURFACE:km. kw. | G_LANG:PL
mm2 | GTYPE:gaz_measurement | G_M_TYPE:space | G_M_UNIT:milimeter2 | SURFACE:mm2
cm2 | GTYPE:gaz_measurement | G_M_TYPE:space | G_M_UNIT:centimeter2 | SURFACE:cm2 
m2 | GTYPE:gaz_measurement | G_M_TYPE:space | G_M_UNIT:meter2 | SURFACE:m2 
km2 | GTYPE:gaz_measurement | G_M_TYPE:space | G_M_UNIT:kilometer2 | SURFACE:km2 
milimetr sześcienny | GTYPE:gaz_measurement | G_M_TYPE:volume | G_M_UNIT:milimeter3 | SURFACE:milimetr sześcienny | G_LANG:PL
milimetra sześciennego | GTYPE:gaz_measurement | G_M_TYPE:volume | G_M_UNIT:milimeter3 | SURFACE:milimetra sześciennego | G_LANG:PL
milimetrowi sześciennemu | GTYPE:gaz_measurement | G_M_TYPE:volume | G_M_UNIT:milimeter3 | SURFACE:milimetrowi sześciennemu | G_LANG:PL
milimetrem sześciennym | GTYPE:gaz_measurement | G_M_TYPE:volume | G_M_UNIT:milimeter3 | SURFACE:milimetrem sześciennym | G_LANG:PL
milimetrze sześciennym | GTYPE:gaz_measurement | G_M_TYPE:volume | G_M_UNIT:milimeter3 | SURFACE:milimetrze sześciennym | G_LANG:PL
centymetr sześcienny | GTYPE:gaz_measurement | G_M_TYPE:volume | G_M_UNIT:centimeter3 | SURFACE:centymetr sześcienny | G_LANG:PL
centymetra sześciennego | GTYPE:gaz_measurement | G_M_TYPE:volume | G_M_UNIT:centimeter3 | SURFACE:centymetra sześciennego | G_LANG:PL
centymetrowi sześciennemu | GTYPE:gaz_measurement | G_M_TYPE:volume | G_M_UNIT:centimeter3 | SURFACE:centymetrowi sześciennemu | G_LANG:PL
centymetrem sześciennym | GTYPE:gaz_measurement | G_M_TYPE:volume | G_M_UNIT:centimeter3 | SURFACE:centymetrem sześciennym | G_LANG:PL
centymetrze sześciennym | GTYPE:gaz_measurement | G_M_TYPE:volume | G_M_UNIT:centimeter3 | SURFACE:centymetrze sześciennym | G_LANG:PL
metr sześcienny | GTYPE:gaz_measurement | G_M_TYPE:volume | G_M_UNIT:meter3 | SURFACE:metr sześcienny | G_LANG:PL
metra sześciennego | GTYPE:gaz_measurement | G_M_TYPE:volume | G_M_UNIT:meter3 | SURFACE:metra sześciennego | G_LANG:PL
metrowi sześciennemu | GTYPE:gaz_measurement | G_M_TYPE:volume | G_M_UNIT:meter3 | SURFACE:metrowi sześciennemu | G_LANG:PL
metrem sześciennym | GTYPE:gaz_measurement | G_M_TYPE:volume | G_M_UNIT:meter3 | SURFACE:metrem sześciennym | G_LANG:PL
metrze sześciennym | GTYPE:gaz_measurement | G_M_TYPE:volume | G_M_UNIT:meter3 | SURFACE:metrze sześciennym | G_LANG:PL
kilometr sześcienny | GTYPE:gaz_measurement | G_M_TYPE:volume | G_M_UNIT:kilometer3 | SURFACE:kilometr sześcienny | G_LANG:PL
kilometra sześciennego | GTYPE:gaz_measurement | G_M_TYPE:volume | G_M_UNIT:kilometer3 | SURFACE:kilometra sześciennego | G_LANG:PL
kilometrowi sześciennemu | GTYPE:gaz_measurement | G_M_TYPE:volume | G_M_UNIT:kilometer3 | SURFACE:kilometrowi sześciennemu | G_LANG:PL
kilometrem sześciennym | GTYPE:gaz_measurement | G_M_TYPE:volume | G_M_UNIT:kilometer3 | SURFACE:kilometrem sześciennym | G_LANG:PL
kilometrze sześciennym | GTYPE:gaz_measurement | G_M_TYPE:volume | G_M_UNIT:kilometer3 | SURFACE:kilometrze sześciennym | G_LANG:PL
milimetry sześcienne | GTYPE:gaz_measurement | G_M_TYPE:volume | G_M_UNIT:milimeter3 | SURFACE:milimetry sześcienne | G_LANG:PL
milimetrami sześciennymi | GTYPE:gaz_measurement | G_M_TYPE:volume | G_M_UNIT:milimeter3 | SURFACE:milimetrami sześciennymi | G_LANG:PL
milimetrom sześciennym | GTYPE:gaz_measurement | G_M_TYPE:volume | G_M_UNIT:milimeter3 | SURFACE:milimetrom sześciennym | G_LANG:PL
milimetrach sześciennych | GTYPE:gaz_measurement | G_M_TYPE:volume | G_M_UNIT:milimeter3 | SURFACE:milimetrach sześciennych | G_LANG:PL
milimetrów sześciennych | GTYPE:gaz_measurement | G_M_TYPE:volume | G_M_UNIT:milimeter3 | SURFACE:milimetrów sześciennych | G_LANG:PL
centymetry sześcienne | GTYPE:gaz_measurement | G_M_TYPE:volume | G_M_UNIT:centimeter3 | SURFACE:centymetry sześcienne | G_LANG:PL
centymetrami sześciennymi | GTYPE:gaz_measurement | G_M_TYPE:volume | G_M_UNIT:centimeter3 | SURFACE:centymetrami sześciennymi | G_LANG:PL
centymetrom sześciennym | GTYPE:gaz_measurement | G_M_TYPE:volume | G_M_UNIT:centimeter3 | SURFACE:centymetrom sześciennym | G_LANG:PL
centymetrach sześciennych | GTYPE:gaz_measurement | G_M_TYPE:volume | G_M_UNIT:centimeter3 | SURFACE:centymetrach sześciennych | G_LANG:PL
centymetrów sześciennych | GTYPE:gaz_measurement | G_M_TYPE:volume | G_M_UNIT:centimeter3 | SURFACE:centymetrów sześciennych | G_LANG:PL
metry sześcienne | GTYPE:gaz_measurement | G_M_TYPE:volume | G_M_UNIT:meter3 | SURFACE:metry sześcienne | G_LANG:PL
metrami sześciennymi | GTYPE:gaz_measurement | G_M_TYPE:volume | G_M_UNIT:meter3 | SURFACE:metrami sześciennymi | G_LANG:PL
metrom sześciennym | GTYPE:gaz_measurement | G_M_TYPE:volume | G_M_UNIT:meter3 | SURFACE:metrom sześciennym | G_LANG:PL
metrach sześciennych | GTYPE:gaz_measurement | G_M_TYPE:volume | G_M_UNIT:meter3 | SURFACE:metrach sześciennych | G_LANG:PL
metrów sześciennych | GTYPE:gaz_measurement | G_M_TYPE:volume | G_M_UNIT:meter3 | SURFACE:metrów sześciennych | G_LANG:PL
kilometry sześcienne | GTYPE:gaz_measurement | G_M_TYPE:volume | G_M_UNIT:kilometer3 | SURFACE:kilometry sześcienne | G_LANG:PL
kilometrami sześciennymi | GTYPE:gaz_measurement | G_M_TYPE:volume | G_M_UNIT:kilometer3 | SURFACE:kilometrami sześciennymi | G_LANG:PL
kilometrom sześciennym | GTYPE:gaz_measurement | G_M_TYPE:volume | G_M_UNIT:kilometer3 | SURFACE:kilometrom sześciennym | G_LANG:PL
kilometrach sześciennych | GTYPE:gaz_measurement | G_M_TYPE:volume | G_M_UNIT:kilometer3 | SURFACE:kilometrach sześciennych | G_LANG:PL
kilometrów sześciennych | GTYPE:gaz_measurement | G_M_TYPE:volume | G_M_UNIT:kilometer3 | SURFACE:kilometrów sześciennych | G_LANG:PL
milimetr sześć. | GTYPE:gaz_measurement | G_M_TYPE:volume | G_M_UNIT:milimeter3 | SURFACE:milimetr sześć. | G_LANG:PL
milimetra sześć. | GTYPE:gaz_measurement | G_M_TYPE:volume | G_M_UNIT:milimeter3 | SURFACE:milimetra sześć. | G_LANG:PL
milimetrowi sześć. | GTYPE:gaz_measurement | G_M_TYPE:volume | G_M_UNIT:milimeter3 | SURFACE:milimetrowi sześć. | G_LANG:PL
milimetrem sześć. | GTYPE:gaz_measurement | G_M_TYPE:volume | G_M_UNIT:milimeter3 | SURFACE:milimetrem sześć. | G_LANG:PL
milimetrze sześć. | GTYPE:gaz_measurement | G_M_TYPE:volume | G_M_UNIT:milimeter3 | SURFACE:milimetrze sześć. | G_LANG:PL
centymetr sześć. | GTYPE:gaz_measurement | G_M_TYPE:volume | G_M_UNIT:centimeter3 | SURFACE:centymetr sześć. | G_LANG:PL
centymetra sześć. | GTYPE:gaz_measurement | G_M_TYPE:volume | G_M_UNIT:centimeter3 | SURFACE:centymetra sześć. | G_LANG:PL
centymetrowi sześć. | GTYPE:gaz_measurement | G_M_TYPE:volume | G_M_UNIT:centimeter3 | SURFACE:centymetrowi sześć. | G_LANG:PL
centymetrem sześć. | GTYPE:gaz_measurement | G_M_TYPE:volume | G_M_UNIT:centimeter3 | SURFACE:centymetrem sześć. | G_LANG:PL
centymetrze sześć. | GTYPE:gaz_measurement | G_M_TYPE:volume | G_M_UNIT:centimeter3 | SURFACE:centymetrze sześć. | G_LANG:PL
metr sześć. | GTYPE:gaz_measurement | G_M_TYPE:volume | G_M_UNIT:meter3 | SURFACE:metr sześć. | G_LANG:PL
metra sześć. | GTYPE:gaz_measurement | G_M_TYPE:volume | G_M_UNIT:meter3 | SURFACE:metra sześć. | G_LANG:PL
metrowi sześć. | GTYPE:gaz_measurement | G_M_TYPE:volume | G_M_UNIT:meter3 | SURFACE:metrowi sześć. | G_LANG:PL
metrem sześć. | GTYPE:gaz_measurement | G_M_TYPE:volume | G_M_UNIT:meter3 | SURFACE:metrem sześć. | G_LANG:PL
metrze sześć. | GTYPE:gaz_measurement | G_M_TYPE:volume | G_M_UNIT:meter3 | SURFACE:metrze sześć. | G_LANG:PL
kilometr sześć. | GTYPE:gaz_measurement | G_M_TYPE:volume | G_M_UNIT:kilometer3 | SURFACE:kilometr sześć. | G_LANG:PL
kilometra sześć. | GTYPE:gaz_measurement | G_M_TYPE:volume | G_M_UNIT:kilometer3 | SURFACE:kilometra sześć. | G_LANG:PL
kilometrowi sześć. | GTYPE:gaz_measurement | G_M_TYPE:volume | G_M_UNIT:kilometer3 | SURFACE:kilometrowi sześć. | G_LANG:PL
kilometrem sześć. | GTYPE:gaz_measurement | G_M_TYPE:volume | G_M_UNIT:kilometer3 | SURFACE:kilometrem sześć. | G_LANG:PL
kilometrze sześć. | GTYPE:gaz_measurement | G_M_TYPE:volume | G_M_UNIT:kilometer3 | SURFACE:kilometrze sześć. | G_LANG:PL
milimetry sześć. | GTYPE:gaz_measurement | G_M_TYPE:volume | G_M_UNIT:milimeter3 | SURFACE:milimetry sześć. | G_LANG:PL
milimetrami sześć. | GTYPE:gaz_measurement | G_M_TYPE:volume | G_M_UNIT:milimeter3 | SURFACE:milimetrami sześć. | G_LANG:PL
milimetrom sześć. | GTYPE:gaz_measurement | G_M_TYPE:volume | G_M_UNIT:milimeter3 | SURFACE:milimetrom sześć. | G_LANG:PL
milimetrach sześć. | GTYPE:gaz_measurement | G_M_TYPE:volume | G_M_UNIT:milimeter3 | SURFACE:milimetrach sześć. | G_LANG:PL
milimetrów sześć. | GTYPE:gaz_measurement | G_M_TYPE:volume | G_M_UNIT:milimeter3 | SURFACE:milimetrów sześć. | G_LANG:PL
centymetry sześć. | GTYPE:gaz_measurement | G_M_TYPE:volume | G_M_UNIT:centimeter3 | SURFACE:centymetry sześć. | G_LANG:PL
centymetrami sześć. | GTYPE:gaz_measurement | G_M_TYPE:volume | G_M_UNIT:centimeter3 | SURFACE:centymetrami sześć. | G_LANG:PL
centymetrom sześć. | GTYPE:gaz_measurement | G_M_TYPE:volume | G_M_UNIT:centimeter3 | SURFACE:centymetrom sześć. | G_LANG:PL
centymetrach sześć. | GTYPE:gaz_measurement | G_M_TYPE:volume | G_M_UNIT:centimeter3 | SURFACE:centymetrach sześć. | G_LANG:PL
centymetrów sześć. | GTYPE:gaz_measurement | G_M_TYPE:volume | G_M_UNIT:centimeter3 | SURFACE:centymetrów sześć. | G_LANG:PL
metry sześć. | GTYPE:gaz_measurement | G_M_TYPE:volume | G_M_UNIT:meter3 | SURFACE:metry sześć. | G_LANG:PL
metrami sześć. | GTYPE:gaz_measurement | G_M_TYPE:volume | G_M_UNIT:meter3 | SURFACE:metrami sześć. | G_LANG:PL
metrom sześć. | GTYPE:gaz_measurement | G_M_TYPE:volume | G_M_UNIT:meter3 | SURFACE:metrom sześć. | G_LANG:PL
metrach sześć. | GTYPE:gaz_measurement | G_M_TYPE:volume | G_M_UNIT:meter3 | SURFACE:metrach sześć. | G_LANG:PL
metrów sześć. | GTYPE:gaz_measurement | G_M_TYPE:volume | G_M_UNIT:meter3 | SURFACE:metrów sześć. | G_LANG:PL
kilometry sześć. | GTYPE:gaz_measurement | G_M_TYPE:volume | G_M_UNIT:kilometer3 | SURFACE:kilometry sześć. | G_LANG:PL 
kilometrami sześć. | GTYPE:gaz_measurement | G_M_TYPE:volume | G_M_UNIT:kilometer3 | SURFACE:kilometrami sześć. | G_LANG:PL
kilometrom sześć. | GTYPE:gaz_measurement | G_M_TYPE:volume | G_M_UNIT:kilometer3 | SURFACE:kilometrom sześć. | G_LANG:PL
kilometrach sześć. | GTYPE:gaz_measurement | G_M_TYPE:volume | G_M_UNIT:kilometer3 | SURFACE:kilometrach sześć. | G_LANG:PL
kilometrów sześć. | GTYPE:gaz_measurement | G_M_TYPE:volume | G_M_UNIT:kilometer3 | SURFACE:kilometrów sześć. | G_LANG:PL
mm sześć. | GTYPE:gaz_measurement | G_M_TYPE:volume | G_M_UNIT:milimeter3 | SURFACE:mm sześć. | G_LANG:PL
cm sześć. | GTYPE:gaz_measurement | G_M_TYPE:volume | G_M_UNIT:centimeter3 | SURFACE:cm sześć. | G_LANG:PL
m sześć. | GTYPE:gaz_measurement | G_M_TYPE:volume | G_M_UNIT:meter3 | SURFACE:m sześć. | G_LANG:PL
km sześć. | GTYPE:gaz_measurement | G_M_TYPE:volume | G_M_UNIT:kilometer3 | SURFACE:km sześć. | G_LANG:PL
mm. sześć. | GTYPE:gaz_measurement | G_M_TYPE:volume | G_M_UNIT:milimeter3 | SURFACE:mm. sześć. | G_LANG:PL
cm. sześć. | GTYPE:gaz_measurement | G_M_TYPE:volume | G_M_UNIT:centimeter3 | SURFACE:cm. sześć. | G_LANG:PL
m. sześć. | GTYPE:gaz_measurement | G_M_TYPE:volume | G_M_UNIT:meter3 | SURFACE:m. sześć. | G_LANG:PL
km. sześć. | GTYPE:gaz_measurement | G_M_TYPE:volume | G_M_UNIT:kilometer3 | SURFACE:km. sześć. | G_LANG:PL
mm3 | GTYPE:gaz_measurement | G_M_TYPE:volume | G_M_UNIT:milimeter3 | SURFACE:mm3
cm3 | GTYPE:gaz_measurement | G_M_TYPE:volume | G_M_UNIT:centimeter3 | SURFACE:cm3
m3 | GTYPE:gaz_measurement | G_M_TYPE:volume | G_M_UNIT:meter3 | SURFACE:m3
km3 | GTYPE:gaz_measurement | G_M_TYPE:volume | G_M_UNIT:kilometer3 | SURFACE:km3
metr na sekundę | GTYPE:gaz_measurement | G_M_TYPE:speed | G_M_UNIT:m-s | SURFACE:metr na sekundę | G_LANG:PL
metra na sekundę | GTYPE:gaz_measurement | G_M_TYPE:speed | G_M_UNIT:m-s | SURFACE:metra na sekundę | G_LANG:PL
metrowi na sekundę | GTYPE:gaz_measurement | G_M_TYPE:speed | G_M_UNIT:m-s | SURFACE:metrowi na sekundę | G_LANG:PL
metrem na sekundę | GTYPE:gaz_measurement | G_M_TYPE:speed | G_M_UNIT:m-s | SURFACE:metrem na sekundę | G_LANG:PL
metrze na sekundę | GTYPE:gaz_measurement | G_M_TYPE:speed | G_M_UNIT:m-s | SURFACE:metrze na sekundę | G_LANG:PL
metry na sekundę | GTYPE:gaz_measurement | G_M_TYPE:speed | G_M_UNIT:m-s | SURFACE:metry na sekundę | G_LANG:PL
metrami na sekundę | GTYPE:gaz_measurement | G_M_TYPE:speed | G_M_UNIT:m-s | SURFACE:metrami na sekundę | G_LANG:PL
metrom na sekundę | GTYPE:gaz_measurement | G_M_TYPE:speed | G_M_UNIT:m-s | SURFACE:metrom na sekundę | G_LANG:PL
metrach na sekundę | GTYPE:gaz_measurement | G_M_TYPE:speed | G_M_UNIT:m-s | SURFACE:metrach na sekundę | G_LANG:PL
metrów na sekundę | GTYPE:gaz_measurement | G_M_TYPE:speed | G_M_UNIT:m-s | SURFACE:metrów na sekundę | G_LANG:PL
kilometr na godzinę | GTYPE:gaz_measurement | G_M_TYPE:speed | G_M_UNIT:m-s | SURFACE:kilometr na godzinę | G_LANG:PL
kilometra na godzinę | GTYPE:gaz_measurement | G_M_TYPE:speed | G_M_UNIT:km-h | SURFACE:kilometra na godzinę | G_LANG:PL
kilometrowi na godzinę | GTYPE:gaz_measurement | G_M_TYPE:speed | G_M_UNIT:km-h | SURFACE:kilometrowi na godzinę | G_LANG:PL
kilometrem na godzinę | GTYPE:gaz_measurement | G_M_TYPE:speed | G_M_UNIT:km-h | SURFACE:kilometrem na godzinę | G_LANG:PL
kilometrze na godzinę | GTYPE:gaz_measurement | G_M_TYPE:speed | G_M_UNIT:km-h | SURFACE:kilometrze na godzinę | G_LANG:PL
kilometry na godzinę | GTYPE:gaz_measurement | G_M_TYPE:speed | G_M_UNIT:km-h | SURFACE:kilometry na godzinę | G_LANG:PL
kilometrami na godzinę | GTYPE:gaz_measurement | G_M_TYPE:speed | G_M_UNIT:km-h | SURFACE:kilometrami na godzinę | G_LANG:PL
kilometrom na godzinę | GTYPE:gaz_measurement | G_M_TYPE:speed | G_M_UNIT:km-h | SURFACE:kilometrom na godzinę | G_LANG:PL
kilometrach na godzinę | GTYPE:gaz_measurement | G_M_TYPE:speed | G_M_UNIT:km-h | SURFACE:kilometrach na godzinę | G_LANG:PL
kilometrów na godzinę | GTYPE:gaz_measurement | G_M_TYPE:speed | G_M_UNIT:km-h | SURFACE:kilometrów na godzinę | G_LANG:PL
km/h | GTYPE:gaz_measurement | G_M_TYPE:speed | G_M_UNIT:km-h | SURFACE:km/h
km na godz. | GTYPE:gaz_measurement | G_M_TYPE:speed | G_M_UNIT:km-h | SURFACE:km na godz. | G_LANG:PL
km. na godz. | GTYPE:gaz_measurement | G_M_TYPE:speed | G_M_UNIT:km-h | SURFACE:km. na godz. | G_LANG:PL
km/godz. | GTYPE:gaz_measurement | G_M_TYPE:speed | G_M_UNIT:km-h | SURFACE:km/godz. | G_LANG:PL
km/godz | GTYPE:gaz_measurement | G_M_TYPE:speed | G_M_UNIT:km-h | SURFACE:km/godz | G_LANG:PL
km. na godzinę | GTYPE:gaz_measurement | G_M_TYPE:speed | G_M_UNIT:km-h | SURFACE:km. na godzinę | G_LANG:PL
m/s | GTYPE:gaz_measurement | G_M_TYPE:speed | G_M_UNIT:m-s | SURFACE:m/s 
stopa | GTYPE:gaz_measurement | G_M_TYPE:physical_extent | G_M_UNIT:foot | SURFACE:stopa | G_LANG:PL
stopy | GTYPE:gaz_measurement | G_M_TYPE:physical_extent | G_M_UNIT:foot | SURFACE:stopy | G_LANG:PL
stóp | GTYPE:gaz_measurement | G_M_TYPE:physical_extent | G_M_UNIT:foot | SURFACE:stóp | G_LANG:PL
cal | GTYPE:gaz_measurement | G_M_TYPE:physical_extent | G_M_UNIT:inch | SURFACE:cal | G_LANG:PL
cala | GTYPE:gaz_measurement | G_M_TYPE:physical_extent | G_M_UNIT:inch | SURFACE:cala | G_LANG:PL
cali | GTYPE:gaz_measurement | G_M_TYPE:physical_extent | G_M_UNIT:inch | SURFACE:cali | G_LANG:PL
calem | GTYPE:gaz_measurement | G_M_TYPE:physical_extent | G_M_UNIT:inch | SURFACE:calem | G_LANG:PL
cale | GTYPE:gaz_measurement | G_M_TYPE:physical_extent | G_M_UNIT:inch | SURFACE:cale | G_LANG:PL
calami | GTYPE:gaz_measurement | G_M_TYPE:physical_extent | G_M_UNIT:inch | SURFACE:calami | G_LANG:PL
yard | GTYPE:gaz_measurement | G_M_TYPE:physical_extent | G_M_UNIT:yard | SURFACE:yard 
jard | GTYPE:gaz_measurement | G_M_TYPE:physical_extent | G_M_UNIT:yard | SURFACE:jard | G_LANG:PL
jarda | GTYPE:gaz_measurement | G_M_TYPE:physical_extent | G_M_UNIT:yard | SURFACE:jarda | G_LANG:PL
jardem | GTYPE:gaz_measurement | G_M_TYPE:physical_extent | G_M_UNIT:yard | SURFACE:jardem | G_LANG:PL
jardów | GTYPE:gaz_measurement | G_M_TYPE:physical_extent | G_M_UNIT:yard | SURFACE:jardów | G_LANG:PL
jardom | GTYPE:gaz_measurement | G_M_TYPE:physical_extent | G_M_UNIT:yard | SURFACE:jardom | G_LANG:PL
jardami | GTYPE:gaz_measurement | G_M_TYPE:physical_extent | G_M_UNIT:yard | SURFACE:jardami | G_LANG:PL
mila | GTYPE:gaz_measurement | G_M_TYPE:physical_extent | G_M_UNIT:mile | SURFACE:mila | G_LANG:PL
mili | GTYPE:gaz_measurement | G_M_TYPE:physical_extent | G_M_UNIT:mile | SURFACE:mili | G_LANG:PL
milą | GTYPE:gaz_measurement | G_M_TYPE:physical_extent | G_M_UNIT:mile | SURFACE:milą | G_LANG:PL
mile | GTYPE:gaz_measurement | G_M_TYPE:physical_extent | G_M_UNIT:mile | SURFACE:mile | G_LANG:PL
milami | GTYPE:gaz_measurement | G_M_TYPE:physical_extent | G_M_UNIT:mile | SURFACE:milami | G_LANG:PL
milach | GTYPE:gaz_measurement | G_M_TYPE:physical_extent | G_M_UNIT:mile | SURFACE:milach | G_LANG:PL
milom | GTYPE:gaz_measurement | G_M_TYPE:physical_extent | G_M_UNIT:mile | SURFACE:milom | G_LANG:PL
mil | GTYPE:gaz_measurement | G_M_TYPE:physical_extent | G_M_UNIT:mile | SURFACE:mil | G_LANG:PL
kilogram | GTYPE:gaz_measurement | G_M_TYPE:weight | G_M_UNIT:kilogram | SURFACE:kilogram | 
kilograma | GTYPE:gaz_measurement | G_M_TYPE:weight | G_M_UNIT:kilogram | SURFACE:kilograma | G_LANG:PL
kilogramowi | GTYPE:gaz_measurement | G_M_TYPE:weight | G_M_UNIT:kilogram | SURFACE:kilogramowi | G_LANG:PL
kilogramem | GTYPE:gaz_measurement | G_M_TYPE:weight | G_M_UNIT:kilogram | SURFACE:kilogramem | G_LANG:PL
kilogramie | GTYPE:gaz_measurement | G_M_TYPE:weight | G_M_UNIT:kilogram | SURFACE:kilogramie | G_LANG:PL
kilogramy | GTYPE:gaz_measurement | G_M_TYPE:weight | G_M_UNIT:kilogram | SURFACE:kilogramy | G_LANG:PL
kilogramów | GTYPE:gaz_measurement | G_M_TYPE:weight | G_M_UNIT:kilogram | SURFACE:kilogramów | G_LANG:PL
kilogramom | GTYPE:gaz_measurement | G_M_TYPE:weight | G_M_UNIT:kilogram | SURFACE:kilogramom | G_LANG:PL
kilogramach | GTYPE:gaz_measurement | G_M_TYPE:weight | G_M_UNIT:kilogram | SURFACE:kilogramach | G_LANG:PL
kilogramami | GTYPE:gaz_measurement | G_M_TYPE:weight | G_M_UNIT:kilogram | SURFACE:kilogramami | G_LANG:PL
kg | GTYPE:gaz_measurement | G_M_TYPE:weight | G_M_UNIT:kilogram | SURFACE:kg
kg. | GTYPE:gaz_measurement | G_M_TYPE:weight | G_M_UNIT:kilogram | SURFACE:kg.
gram | GTYPE:gaz_measurement | G_M_TYPE:weight | G_M_UNIT:gram | SURFACE:gram | 
grama | GTYPE:gaz_measurement | G_M_TYPE:weight | G_M_UNIT:gram | SURFACE:grama | G_LANG:PL
gramowi | GTYPE:gaz_measurement | G_M_TYPE:weight | G_M_UNIT:gram | SURFACE:gramowi | G_LANG:PL
gramem | GTYPE:gaz_measurement | G_M_TYPE:weight | G_M_UNIT:gram | SURFACE:gramem | G_LANG:PL
gramie | GTYPE:gaz_measurement | G_M_TYPE:weight | G_M_UNIT:gram | SURFACE:gramie | G_LANG:PL
gramy | GTYPE:gaz_measurement | G_M_TYPE:weight | G_M_UNIT:gram | SURFACE:gramy | G_LANG:PL
gramów | GTYPE:gaz_measurement | G_M_TYPE:weight | G_M_UNIT:gram | SURFACE:gramów | G_LANG:PL
gramach | GTYPE:gaz_measurement | G_M_TYPE:weight | G_M_UNIT:gram | SURFACE:gramach | G_LANG:PL
gramom | GTYPE:gaz_measurement | G_M_TYPE:weight | G_M_UNIT:gram | SURFACE:gramom | G_LANG:PL
gramami | GTYPE:gaz_measurement | G_M_TYPE:weight | G_M_UNIT:gram | SURFACE:gramami | G_LANG:PL
g. | GTYPE:gaz_measurement | G_M_TYPE:weight | G_M_UNIT:gram | SURFACE:g.
g | GTYPE:gaz_measurement | G_M_TYPE:weight | G_M_UNIT:gram | SURFACE:g
miligram | GTYPE:gaz_measurement | G_M_TYPE:weight | G_M_UNIT:miligram | SURFACE:miligram | 
miligrama | GTYPE:gaz_measurement | G_M_TYPE:weight | G_M_UNIT:miligram | SURFACE:miligrama | G_LANG:PL
miligramowi | GTYPE:gaz_measurement | G_M_TYPE:weight | G_M_UNIT:miligram | SURFACE:miligramowi | G_LANG:PL
miligramem | GTYPE:gaz_measurement | G_M_TYPE:weight | G_M_UNIT:miligram | SURFACE:miligramem | G_LANG:PL
miligramie | GTYPE:gaz_measurement | G_M_TYPE:weight | G_M_UNIT:miligram | SURFACE:miligramie | G_LANG:PL
miligramy | GTYPE:gaz_measurement | G_M_TYPE:weight | G_M_UNIT:miligram | SURFACE:miligramy | G_LANG:PL
miligramów | GTYPE:gaz_measurement | G_M_TYPE:weight | G_M_UNIT:miligram | SURFACE:miligramów | G_LANG:PL
miligramom | GTYPE:gaz_measurement | G_M_TYPE:weight | G_M_UNIT:miligram | SURFACE:miligramom | G_LANG:PL
miligramach | GTYPE:gaz_measurement | G_M_TYPE:weight | G_M_UNIT:miligram | SURFACE:miligramach | G_LANG:PL
miligramami | GTYPE:gaz_measurement | G_M_TYPE:weight | G_M_UNIT:miligram | SURFACE:miligramami | G_LANG:PL
mg. | GTYPE:gaz_measurement | G_M_TYPE:weight | G_M_UNIT:miligram | SURFACE:mg.
mg | GTYPE:gaz_measurement | G_M_TYPE:weight | G_M_UNIT:miligram | SURFACE:mg
dekagram | GTYPE:gaz_measurement | G_M_TYPE:weight | G_M_UNIT:decagram | SURFACE:dekagram | 
dekagrama | GTYPE:gaz_measurement | G_M_TYPE:weight | G_M_UNIT:decagram | SURFACE:dekagrama | G_LANG:PL
dekagramowi | GTYPE:gaz_measurement | G_M_TYPE:weight | G_M_UNIT:decagram | SURFACE:dekagramowi | G_LANG:PL
dekagramem | GTYPE:gaz_measurement | G_M_TYPE:weight | G_M_UNIT:decagram | SURFACE:dekagramem | G_LANG:PL
dekagramie | GTYPE:gaz_measurement | G_M_TYPE:weight | G_M_UNIT:decagram | SURFACE:dekagramie | G_LANG:PL
dekagramy | GTYPE:gaz_measurement | G_M_TYPE:weight | G_M_UNIT:decagram | SURFACE:dekagramy | G_LANG:PL
dekagramów | GTYPE:gaz_measurement | G_M_TYPE:weight | G_M_UNIT:decagram | SURFACE:dekagramów | G_LANG:PL
dekagramach | GTYPE:gaz_measurement | G_M_TYPE:weight | G_M_UNIT:decagram | SURFACE:dekagramach | G_LANG:PL
dekagramom | GTYPE:gaz_measurement | G_M_TYPE:weight | G_M_UNIT:decagram | SURFACE:dekagramom | G_LANG:PL
dekagramami | GTYPE:gaz_measurement | G_M_TYPE:weight | G_M_UNIT:decagram | SURFACE:dekagramami | G_LANG:PL
dkg. | GTYPE:gaz_measurement | G_M_TYPE:weight | G_M_UNIT:decagram | SURFACE:dkg.
dkg | GTYPE:gaz_measurement | G_M_TYPE:weight | G_M_UNIT:decagram | SURFACE:dkg
tona | GTYPE:gaz_measurement | G_M_TYPE:weight | G_M_UNIT:tone | SURFACE:tona | G_LANG:PL
ton | GTYPE:gaz_measurement | G_M_TYPE:weight | G_M_UNIT:tone | SURFACE:tonG_LANG:PL
tony | GTYPE:gaz_measurement | G_M_TYPE:weight | G_M_UNIT:tone | SURFACE:tony | G_LANG:PL
tonę | GTYPE:gaz_measurement | G_M_TYPE:weight | G_M_UNIT:tone | SURFACE:tonę | G_LANG:PL
toną | GTYPE:gaz_measurement | G_M_TYPE:weight | G_M_UNIT:tone | SURFACE:toną | G_LANG:PL
tonie | GTYPE:gaz_measurement | G_M_TYPE:weight | G_M_UNIT:tone | SURFACE:tonie | G_LANG:PL
tony | GTYPE:gaz_measurement | G_M_TYPE:weight | G_M_UNIT:tone | SURFACE:tony | G_LANG:PL
tonami | GTYPE:gaz_measurement | G_M_TYPE:weight | G_M_UNIT:tone | SURFACE:tonami | G_LANG:PL
tonom | GTYPE:gaz_measurement | G_M_TYPE:weight | G_M_UNIT:tone | SURFACE:tonom | G_LANG:PL
tonach | GTYPE:gaz_measurement | G_M_TYPE:weight | G_M_UNIT:tone | SURFACE:tonach | G_LANG:PL
tonami | GTYPE:gaz_measurement | G_M_TYPE:weight | G_M_UNIT:tone | SURFACE:tonami | G_LANG:PL
t | GTYPE:gaz_measurement | G_M_TYPE:weight | G_M_UNIT:tone | SURFACE:tG_LANG:PL
kwintal | GTYPE:gaz_measurement | G_M_TYPE:weight | G_M_UNIT:quintal | SURFACE:kG_LANG:PLwintal | 
kwintali | GTYPE:gaz_measurement | G_M_TYPE:weight | G_M_UNIT:quintal | SURFACE:kwintali G_LANG:PL| 
kwintala | GTYPE:gaz_measurement | G_M_TYPE:weight | G_M_UNIT:quintal | SURFACE:kwintala | G_LANG:PL
kwintalem | GTYPE:gaz_measurement | G_M_TYPE:weight | G_M_UNIT:quintal | SURFACE:kwintalem | G_LANG:PL
kwintalu | GTYPE:gaz_measurement | G_M_TYPE:weight | G_M_UNIT:quintal | SURFACE:kwintalu | G_LANG:PL
kwinatalami | GTYPE:gaz_measurement | G_M_TYPE:weight | G_M_UNIT:quintal | SURFACE:kwinatalami | G_LANG:PL
kwinatalom | GTYPE:gaz_measurement | G_M_TYPE:weight | G_M_UNIT:quintal | SURFACE:kwinatalom | G_LANG:PL
kwintale | GTYPE:gaz_measurement | G_M_TYPE:weight | G_M_UNIT:quintal | SURFACE:kwintale | G_LANG:PL
kwintalach | GTYPE:gaz_measurement | G_M_TYPE:weight | G_M_UNIT:quintal | SURFACE:kwintalach | G_LANG:PL
ar | GTYPE:gaz_measurement | G_M_TYPE:space | G_M_UNIT:ar | SURFACE:ar | G_LANG:PL
arem | GTYPE:gaz_measurement | G_M_TYPE:space | G_M_UNIT:ar | SURFACE:arem | G_LANG:PL
arowi | GTYPE:gaz_measurement | G_M_TYPE:space | G_M_UNIT:ar | SURFACE:arowi | G_LANG:PL
arów | GTYPE:gaz_measurement | G_M_TYPE:space | G_M_UNIT:ar | SURFACE:arów | G_LANG:PL
ary | GTYPE:gaz_measurement | G_M_TYPE:space | G_M_UNIT:ar | SURFACE:ary | G_LANG:PL
arami | GTYPE:gaz_measurement | G_M_TYPE:space | G_M_UNIT:ar | SURFACE:arami | G_LANG:PL
arom | GTYPE:gaz_measurement | G_M_TYPE:space | G_M_UNIT:ar | SURFACE:arom | G_LANG:PL
arach | GTYPE:gaz_measurement | G_M_TYPE:space | G_M_UNIT:ar | SURFACE:arach | G_LANG:PL
hektar | GTYPE:gaz_measurement | G_M_TYPE:space | G_M_UNIT:hectar | SURFACE:hektar | G_LANG:PL
hektara | GTYPE:gaz_measurement | G_M_TYPE:space | G_M_UNIT:hectar | SURFACE:hektara | G_LANG:PL
hektarowi | GTYPE:gaz_measurement | G_M_TYPE:space | G_M_UNIT:hectar | SURFACE:hektarowi | G_LANG:PL
hektarem | GTYPE:gaz_measurement | G_M_TYPE:space | G_M_UNIT:hectar | SURFACE:hektarem | G_LANG:PL
hektarze | GTYPE:gaz_measurement | G_M_TYPE:space | G_M_UNIT:hectar | SURFACE:hektarze | G_LANG:PL
hektary | GTYPE:gaz_measurement | G_M_TYPE:space | G_M_UNIT:hectar | SURFACE:hektary | G_LANG:PL
hektarami | GTYPE:gaz_measurement | G_M_TYPE:space | G_M_UNIT:hectar | SURFACE:hektarami | G_LANG:PL
hektarów | GTYPE:gaz_measurement | G_M_TYPE:space | G_M_UNIT:hectar | SURFACE:hektarów | G_LANG:PL
hektarom | GTYPE:gaz_measurement | G_M_TYPE:space | G_M_UNIT:hectar | SURFACE:hektarom | G_LANG:PL
hektarach | GTYPE:gaz_measurement | G_M_TYPE:space | G_M_UNIT:hectar | SURFACE:hektarach | G_LANG:PL
hekt. | GTYPE:gaz_measurement | G_M_TYPE:space | G_M_UNIT:hectar | SURFACE:hekt. | G_LANG:PL
hekt | GTYPE:gaz_measurement | G_M_TYPE:space | G_M_UNIT:hectar | SURFACE:hekt | G_LANG:PL
litr | GTYPE:gaz_measurement | G_M_TYPE:volume | G_M_UNIT:liter | SURFACE:litr | G_LANG:PL
litra | GTYPE:gaz_measurement | G_M_TYPE:volume | G_M_UNIT:liter | SURFACE:litra | G_LANG:PL
litrem | GTYPE:gaz_measurement | G_M_TYPE:volume | G_M_UNIT:liter | SURFACE:litrem | G_LANG:PL
litrowi | GTYPE:gaz_measurement | G_M_TYPE:volume | G_M_UNIT:liter | SURFACE:litrowi | G_LANG:PL
litrze | GTYPE:gaz_measurement | G_M_TYPE:volume | G_M_UNIT:liter | SURFACE:litrze | G_LANG:PL
litry | GTYPE:gaz_measurement | G_M_TYPE:volume | G_M_UNIT:liter | SURFACE:litry | G_LANG:PL
litrami | GTYPE:gaz_measurement | G_M_TYPE:volume | G_M_UNIT:liter | SURFACE:litrami | G_LANG:PL
litrom | GTYPE:gaz_measurement | G_M_TYPE:volume | G_M_UNIT:liter | SURFACE:litrom | G_LANG:PL
litrach | GTYPE:gaz_measurement | G_M_TYPE:volume | G_M_UNIT:liter | SURFACE:litrach | G_LANG:PL
litrów | GTYPE:gaz_measurement | G_M_TYPE:volume | G_M_UNIT:liter | SURFACE:litrów | G_LANG:PL
l | GTYPE:gaz_measurement | G_M_TYPE:volume | G_M_UNIT:liter | SURFACE:l
l. | GTYPE:gaz_measurement | G_M_TYPE:volume | G_M_UNIT:liter | SURFACE:l.
mililitr | GTYPE:gaz_measurement | G_M_TYPE:volume | G_M_UNIT:mililiter | SURFACE:mililitr 
mililitra | GTYPE:gaz_measurement | G_M_TYPE:volume | G_M_UNIT:mililiter | SURFACE:mililitra | G_LANG:PL
mililitrem | GTYPE:gaz_measurement | G_M_TYPE:volume | G_M_UNIT:mililiter | SURFACE:mililitrem | G_LANG:PL
mililitrowi | GTYPE:gaz_measurement | G_M_TYPE:volume | G_M_UNIT:mililiter | SURFACE:mililitrowi | G_LANG:PL
mililitrze | GTYPE:gaz_measurement | G_M_TYPE:volume | G_M_UNIT:mililiter | SURFACE:mililitrze | G_LANG:PL
mililitry | GTYPE:gaz_measurement | G_M_TYPE:volume | G_M_UNIT:mililiter | SURFACE:mililitry | G_LANG:PL
mililitrami | GTYPE:gaz_measurement | G_M_TYPE:volume | G_M_UNIT:mililiter | SURFACE:mililitrami | G_LANG:PL
mililitrom | GTYPE:gaz_measurement | G_M_TYPE:volume | G_M_UNIT:mililiter | SURFACE:mililitrom | G_LANG:PL
mililitrach | GTYPE:gaz_measurement | G_M_TYPE:volume | G_M_UNIT:mililiter | SURFACE:mililitrach | G_LANG:PL
mililitrów | GTYPE:gaz_measurement | G_M_TYPE:volume | G_M_UNIT:mililiter | SURFACE:mililitrów | G_LANG:PL
ml | GTYPE:gaz_measurement | G_M_TYPE:volume | G_M_UNIT:mililiter | SURFACE:ml
ml. | GTYPE:gaz_measurement | G_M_TYPE:volume | G_M_UNIT:mililiter | SURFACE:ml.
galon | GTYPE:gaz_measurement | G_M_TYPE:volume | G_M_UNIT:galon | SURFACE:galon | 
galona | GTYPE:gaz_measurement | G_M_TYPE:volume | G_M_UNIT:galon | SURFACE:galona | G_LANG:PL
galonem | GTYPE:gaz_measurement | G_M_TYPE:volume | G_M_UNIT:galon | SURFACE:galonem | G_LANG:PL
galonowi | GTYPE:gaz_measurement | G_M_TYPE:volume | G_M_UNIT:galon | SURFACE:galonowi | G_LANG:PL
galonie | GTYPE:gaz_measurement | G_M_TYPE:volume | G_M_UNIT:galon | SURFACE:galonie | G_LANG:PL
galony | GTYPE:gaz_measurement | G_M_TYPE:volume | G_M_UNIT:galon | SURFACE:galony | G_LANG:PL
galonom | GTYPE:gaz_measurement | G_M_TYPE:volume | G_M_UNIT:galon | SURFACE:galonom | G_LANG:PL
galonami | GTYPE:gaz_measurement | G_M_TYPE:volume | G_M_UNIT:galon | SURFACE:galonami | G_LANG:PL
galonach | GTYPE:gaz_measurement | G_M_TYPE:volume | G_M_UNIT:galon | SURFACE:galonach | G_LANG:PL
galonów | GTYPE:gaz_measurement | G_M_TYPE:volume | G_M_UNIT:galon | SURFACE:galonów | G_LANG:PL
baryłka | GTYPE:gaz_measurement | G_M_TYPE:volume | G_M_UNIT:barrel | SURFACE:baryłka | G_LANG:PL
baryłki | GTYPE:gaz_measurement | G_M_TYPE:volume | G_M_UNIT:barrel | SURFACE:baryłki | G_LANG:PL
baryłce | GTYPE:gaz_measurement | G_M_TYPE:volume | G_M_UNIT:barrel | SURFACE:baryłce | G_LANG:PL
baryłką | GTYPE:gaz_measurement | G_M_TYPE:volume | G_M_UNIT:barrel | SURFACE:baryłką | G_LANG:PL
baryłkę | GTYPE:gaz_measurement | G_M_TYPE:volume | G_M_UNIT:barrel | SURFACE:baryłkę | G_LANG:PL
baryłki | GTYPE:gaz_measurement | G_M_TYPE:volume | G_M_UNIT:barrel | SURFACE:baryłki | G_LANG:PL
baryłkom | GTYPE:gaz_measurement | G_M_TYPE:volume | G_M_UNIT:barrel | SURFACE:baryłkom | G_LANG:PL
baryłkach | GTYPE:gaz_measurement | G_M_TYPE:volume | G_M_UNIT:barrel | SURFACE:baryłkach | G_LANG:PL
baryłkami | GTYPE:gaz_measurement | G_M_TYPE:volume | G_M_UNIT:barrel | SURFACE:baryłkami | G_LANG:PL
baryłek | GTYPE:gaz_measurement | G_M_TYPE:volume | G_M_UNIT:barrel | SURFACE:baryłek | G_LANG:PL


